Ready Processes,Processes in CPU,Blocked processes,Completed processes,Accounted For, Number of CPUs,Exiting at simulation time
9339, 2, 0, 659,10000, 2, 10000
9352, 2, 0, 646,10000, 2, 10000
9383, 2, 0, 615,10000, 2, 10000
9336, 2, 0, 662,10000, 2, 10000
9359, 2, 0, 639,10000, 2, 10000
9371, 2, 0, 627,10000, 2, 10000
9346, 2, 0, 652,10000, 2, 10000
9348, 2, 0, 650,10000, 2, 10000
9335, 2, 0, 664,10001, 2, 10000
9342, 2, 0, 656,10000, 2, 10000
4350, 2, 0, 569,4921, 2, 10000
4464, 2, 0, 603,5069, 2, 10000
4386, 2, 0, 628,5016, 2, 10000
4434, 2, 0, 535,4971, 2, 10000
4508, 2, 0, 528,5038, 2, 10000
4366, 2, 0, 601,4969, 2, 10000
4432, 2, 0, 546,4980, 2, 10000
4351, 2, 0, 566,4919, 2, 10000
4486, 2, 0, 574,5062, 2, 10000
4457, 2, 0, 593,5052, 2, 10000
2882, 2, 0, 454,3338, 2, 10000
2861, 2, 0, 456,3319, 2, 10000
2769, 2, 0, 479,3250, 2, 10000
2806, 2, 0, 472,3280, 2, 10000
2882, 2, 0, 437,3321, 2, 10000
2935, 2, 0, 494,3431, 2, 10000
2811, 2, 0, 474,3287, 2, 10000
2947, 2, 0, 464,3413, 2, 10000
2900, 2, 0, 467,3369, 2, 10000
2807, 2, 0, 514,3323, 2, 10000
2122, 2, 0, 389,2513, 2, 10000
2142, 2, 0, 385,2529, 2, 10000
2093, 2, 0, 406,2501, 2, 10000
2077, 2, 0, 393,2472, 2, 10000
2066, 2, 0, 379,2447, 2, 10000
2010, 2, 0, 407,2419, 2, 10000
2144, 2, 0, 407,2553, 2, 10000
2074, 2, 0, 368,2444, 2, 10000
2141, 2, 0, 368,2511, 2, 10000
2192, 2, 0, 391,2585, 2, 10000
1648, 2, 0, 325,1975, 2, 10000
1663, 2, 0, 335,2000, 2, 10000
1649, 2, 0, 347,1998, 2, 10000
1696, 2, 0, 325,2023, 2, 10000
1713, 2, 0, 303,2018, 2, 10000
1681, 2, 0, 330,2013, 2, 10000
1643, 2, 0, 377,2022, 2, 10000
1676, 2, 0, 328,2006, 2, 10000
1589, 2, 0, 326,1917, 2, 10000
1680, 2, 0, 323,2005, 2, 10000
1401, 2, 0, 307,1710, 2, 10000
1374, 2, 0, 301,1677, 2, 10000
1399, 2, 0, 313,1714, 2, 10000
1357, 2, 0, 309,1668, 2, 10000
1338, 2, 0, 322,1662, 2, 10000
1439, 2, 0, 291,1732, 2, 10000
1390, 2, 0, 298,1690, 2, 10000
1374, 2, 0, 323,1699, 2, 10000
1372, 2, 0, 287,1661, 2, 10000
1431, 2, 0, 268,1701, 2, 10000
1190, 2, 0, 256,1448, 2, 10000
1129, 2, 0, 240,1371, 2, 10000
1240, 2, 0, 262,1504, 2, 10000
1147, 2, 0, 252,1401, 2, 10000
1134, 2, 0, 261,1397, 2, 10000
1177, 2, 0, 258,1437, 2, 10000
1207, 2, 0, 243,1452, 2, 10000
1146, 2, 0, 284,1432, 2, 10000
1183, 2, 0, 255,1440, 2, 10000
1184, 2, 0, 281,1467, 2, 10000
1059, 2, 0, 206,1267, 2, 10000
963, 2, 0, 256,1221, 2, 10000
998, 2, 0, 233,1233, 2, 10000
1018, 2, 0, 230,1250, 2, 10000
1080, 2, 0, 250,1332, 2, 10000
1000, 2, 0, 255,1257, 2, 10000
963, 2, 0, 244,1209, 2, 10000
968, 2, 0, 232,1202, 2, 10000
1016, 2, 0, 245,1263, 2, 10000
1046, 2, 0, 240,1288, 2, 10000
904, 2, 0, 197,1103, 2, 10000
893, 2, 0, 197,1092, 2, 10000
939, 2, 0, 199,1140, 2, 10000
909, 2, 0, 226,1137, 2, 10000
894, 2, 0, 219,1115, 2, 10000
943, 2, 0, 216,1161, 2, 10000
874, 2, 0, 202,1078, 2, 10000
886, 2, 0, 218,1106, 2, 10000
924, 2, 0, 213,1139, 2, 10000
898, 2, 0, 204,1104, 2, 10000
820, 2, 0, 183,1005, 2, 10000
830, 2, 0, 216,1048, 2, 10000
816, 2, 0, 198,1016, 2, 10000
799, 2, 0, 223,1024, 2, 10000
820, 2, 0, 173,995, 2, 10000
821, 2, 0, 210,1033, 2, 10000
773, 2, 0, 219,994, 2, 10000
802, 2, 0, 183,987, 2, 10000
767, 2, 0, 200,969, 2, 10000
754, 2, 0, 190,946, 2, 10000
709, 2, 0, 184,895, 2, 10000
698, 2, 0, 191,891, 2, 10000
760, 2, 0, 168,930, 2, 10000
776, 2, 0, 172,950, 2, 10000
754, 2, 0, 186,942, 2, 10000
714, 2, 0, 169,885, 2, 10000
736, 2, 0, 181,919, 2, 10000
692, 2, 0, 154,848, 2, 10000
720, 2, 0, 181,903, 2, 10000
727, 2, 0, 191,920, 2, 10000
673, 2, 0, 157,832, 2, 10000
635, 2, 0, 157,794, 2, 10000
694, 2, 0, 165,861, 2, 10000
646, 2, 0, 150,798, 2, 10000
666, 2, 0, 173,841, 2, 10000
646, 2, 0, 165,813, 2, 10000
679, 2, 0, 160,841, 2, 10000
659, 2, 0, 173,834, 2, 10000
638, 2, 0, 150,790, 2, 10000
653, 2, 0, 171,826, 2, 10000
644, 2, 0, 131,777, 2, 10000
644, 2, 0, 152,798, 2, 10000
634, 2, 0, 161,797, 2, 10000
606, 2, 0, 166,774, 2, 10000
640, 2, 0, 151,793, 2, 10000
634, 2, 0, 159,795, 2, 10000
608, 2, 0, 140,750, 2, 10000
633, 2, 0, 151,786, 2, 10000
667, 2, 0, 176,845, 2, 10000
595, 2, 0, 171,768, 2, 10000
584, 2, 0, 151,737, 2, 10000
584, 2, 0, 154,740, 2, 10000
561, 2, 0, 134,697, 2, 10000
587, 2, 0, 131,720, 2, 10000
603, 2, 0, 147,752, 2, 10000
561, 2, 0, 168,731, 2, 10000
608, 2, 0, 155,765, 2, 10000
553, 2, 0, 143,698, 2, 10000
562, 2, 0, 142,706, 2, 10000
579, 2, 0, 140,721, 2, 10000
532, 2, 0, 137,671, 2, 10000
519, 2, 0, 125,646, 2, 10000
535, 2, 0, 123,660, 2, 10000
524, 2, 0, 134,660, 2, 10000
514, 2, 0, 121,637, 2, 10000
556, 2, 0, 124,682, 2, 10000
574, 2, 0, 128,704, 2, 10000
544, 2, 0, 163,709, 2, 10000
536, 2, 0, 122,660, 2, 10000
560, 2, 0, 123,685, 2, 10000
523, 2, 0, 137,662, 2, 10000
508, 2, 0, 150,660, 2, 10000
511, 2, 0, 115,628, 2, 10000
522, 2, 0, 105,629, 2, 10000
488, 2, 0, 119,609, 2, 10000
508, 2, 0, 132,642, 2, 10000
508, 2, 0, 98,608, 2, 10000
462, 2, 0, 105,569, 2, 10000
528, 2, 0, 133,663, 2, 10000
505, 2, 0, 137,644, 2, 10000
493, 2, 0, 121,616, 2, 10000
474, 2, 0, 124,600, 2, 10000
495, 2, 0, 114,611, 2, 10000
460, 2, 0, 101,563, 2, 10000
428, 2, 0, 122,552, 2, 10000
484, 2, 0, 133,619, 2, 10000
470, 2, 0, 129,601, 2, 10000
441, 2, 0, 125,568, 2, 10000
483, 2, 0, 119,604, 2, 10000
454, 2, 0, 133,589, 2, 10000
435, 2, 0, 112,549, 2, 10000
456, 2, 0, 109,567, 2, 10000
446, 2, 0, 99,547, 2, 10000
441, 2, 0, 82,525, 2, 10000
466, 2, 0, 107,575, 2, 10000
429, 2, 0, 108,539, 2, 10000
458, 2, 0, 116,576, 2, 10000
409, 2, 0, 111,522, 2, 10000
425, 2, 0, 110,537, 2, 10000
428, 2, 0, 132,562, 2, 10000
410, 2, 0, 125,537, 2, 10000
439, 2, 0, 112,553, 2, 10000
408, 2, 0, 95,505, 2, 10000
419, 2, 0, 111,532, 2, 10000
387, 2, 0, 137,526, 2, 10000
413, 2, 0, 92,507, 2, 10000
394, 2, 0, 111,507, 2, 10000
414, 2, 0, 107,523, 2, 10000
408, 2, 0, 103,513, 2, 10000
402, 2, 0, 97,501, 2, 10000
370, 2, 0, 120,492, 2, 10000
412, 2, 0, 118,532, 2, 10000
428, 2, 0, 104,534, 2, 10000
385, 2, 0, 102,489, 2, 10000
402, 2, 0, 93,497, 2, 10000
372, 2, 0, 93,467, 2, 10000
387, 2, 0, 102,491, 2, 10000
410, 2, 0, 91,503, 2, 10000
378, 2, 0, 98,478, 2, 10000
411, 2, 0, 108,521, 2, 10000
351, 2, 0, 96,449, 2, 10000
357, 2, 0, 91,450, 2, 10000
345, 2, 0, 91,438, 2, 10000
406, 2, 0, 103,511, 2, 10000
368, 2, 0, 98,468, 2, 10000
373, 2, 0, 103,478, 2, 10000
385, 2, 0, 105,492, 2, 10000
387, 2, 0, 87,476, 2, 10000
365, 2, 0, 95,462, 2, 10000
355, 2, 0, 109,466, 2, 10000
343, 2, 0, 104,449, 2, 10000
337, 2, 0, 94,433, 2, 10000
339, 2, 0, 109,450, 2, 10000
341, 2, 0, 95,438, 2, 10000
385, 2, 0, 89,476, 2, 10000
387, 2, 0, 90,479, 2, 10000
369, 2, 0, 85,456, 2, 10000
301, 2, 0, 87,390, 2, 10000
349, 2, 0, 90,441, 2, 10000
361, 2, 0, 80,443, 2, 10000
346, 2, 0, 94,442, 2, 10000
331, 2, 0, 89,422, 2, 10000
380, 2, 0, 93,475, 2, 10000
364, 2, 0, 100,466, 2, 10000
333, 2, 0, 98,433, 2, 10000
346, 2, 0, 71,419, 2, 10000
338, 2, 0, 83,423, 2, 10000
332, 2, 0, 103,437, 2, 10000
353, 2, 0, 82,437, 2, 10000
305, 2, 0, 87,394, 2, 10000
335, 2, 0, 83,420, 2, 10000
308, 2, 0, 105,415, 2, 10000
335, 2, 0, 73,410, 2, 10000
322, 2, 0, 98,422, 2, 10000
300, 2, 0, 73,375, 2, 10000
329, 2, 0, 98,429, 2, 10000
337, 2, 0, 73,412, 2, 10000
325, 2, 0, 73,400, 2, 10000
312, 2, 0, 90,404, 2, 10000
319, 2, 0, 82,403, 2, 10000
296, 2, 0, 90,388, 2, 10000
321, 2, 0, 73,396, 2, 10000
329, 2, 0, 80,411, 2, 10000
294, 2, 0, 80,376, 2, 10000
340, 2, 0, 75,417, 2, 10000
309, 2, 0, 86,397, 2, 10000
345, 2, 0, 76,423, 2, 10000
305, 2, 0, 88,395, 2, 10000
322, 2, 0, 71,395, 2, 10000
293, 2, 0, 85,380, 2, 10000
314, 2, 0, 83,399, 2, 10000
309, 2, 0, 97,408, 2, 10000
312, 2, 0, 86,400, 2, 10000
312, 2, 0, 70,384, 2, 10000
326, 2, 0, 90,418, 2, 10000
300, 2, 0, 92,394, 2, 10000
313, 2, 0, 74,389, 2, 10000
310, 2, 0, 70,382, 2, 10000
313, 2, 0, 74,389, 2, 10000
306, 2, 0, 82,390, 2, 10000
317, 2, 0, 76,395, 2, 10000
272, 2, 0, 76,350, 2, 10000
276, 2, 0, 74,352, 2, 10000
298, 2, 0, 70,370, 2, 10000
296, 2, 0, 75,373, 2, 10000
251, 2, 0, 80,333, 2, 10000
321, 2, 0, 78,401, 2, 10000
283, 2, 0, 84,369, 2, 10000
279, 2, 0, 86,367, 2, 10000
263, 2, 0, 75,340, 2, 10000
290, 2, 0, 60,352, 2, 10000
290, 2, 0, 63,355, 2, 10000
287, 2, 0, 77,366, 2, 10000
285, 2, 0, 62,349, 2, 10000
278, 2, 0, 80,360, 2, 10000
294, 2, 0, 65,361, 2, 10000
259, 2, 0, 79,340, 2, 10000
270, 2, 0, 55,327, 2, 10000
271, 2, 0, 74,347, 2, 10000
255, 2, 0, 70,327, 2, 10000
274, 2, 0, 57,333, 2, 10000
261, 2, 0, 62,325, 2, 10000
279, 2, 0, 78,359, 2, 10000
284, 2, 0, 81,367, 2, 10000
288, 2, 0, 79,369, 2, 10000
240, 2, 0, 73,315, 2, 10000
266, 2, 0, 71,339, 2, 10000
265, 2, 0, 81,348, 2, 10000
253, 2, 0, 66,321, 2, 10000
275, 2, 0, 74,351, 2, 10000
270, 2, 0, 56,328, 2, 10000
235, 2, 0, 69,306, 2, 10000
273, 2, 0, 82,357, 2, 10000
255, 2, 0, 68,325, 2, 10000
251, 2, 0, 67,320, 2, 10000
277, 2, 0, 73,352, 2, 10000
274, 2, 0, 75,351, 2, 10000
270, 2, 0, 53,325, 2, 10000
284, 2, 0, 66,352, 2, 10000
280, 2, 0, 65,347, 2, 10000
222, 2, 0, 65,289, 2, 10000
262, 2, 0, 53,317, 2, 10000
279, 2, 0, 89,370, 2, 10000
232, 2, 0, 68,302, 2, 10000
277, 2, 0, 72,351, 2, 10000
241, 2, 0, 55,298, 2, 10000
236, 2, 0, 76,314, 2, 10000
249, 2, 0, 67,318, 2, 10000
248, 2, 0, 68,318, 2, 10000
246, 2, 0, 80,328, 2, 10000
247, 2, 0, 60,309, 2, 10000
241, 2, 0, 71,314, 2, 10000
242, 2, 0, 52,296, 2, 10000
235, 2, 0, 80,317, 2, 10000
267, 2, 0, 58,327, 2, 10000
240, 2, 0, 68,310, 2, 10000
257, 2, 0, 72,331, 2, 10000
219, 2, 0, 74,295, 2, 10000
240, 2, 0, 52,294, 2, 10000
231, 2, 0, 81,314, 2, 10000
221, 2, 0, 64,287, 2, 10000
239, 2, 0, 55,296, 2, 10000
226, 2, 0, 70,298, 2, 10000
217, 2, 0, 83,302, 2, 10000
225, 2, 0, 75,302, 2, 10000
220, 2, 0, 60,282, 2, 10000
232, 2, 0, 63,297, 2, 10000
218, 2, 0, 65,285, 2, 10000
255, 2, 0, 63,320, 2, 10000
234, 2, 0, 68,304, 2, 10000
219, 2, 0, 51,272, 2, 10000
250, 2, 0, 68,320, 2, 10000
246, 2, 0, 53,301, 2, 10000
213, 2, 0, 61,276, 2, 10000
219, 2, 0, 58,279, 2, 10000
199, 2, 0, 55,256, 2, 10000
226, 2, 0, 68,296, 2, 10000
224, 2, 0, 78,304, 2, 10000
209, 2, 0, 51,262, 2, 10000
234, 2, 0, 76,312, 2, 10000
224, 2, 0, 64,290, 2, 10000
229, 2, 0, 71,302, 2, 10000
234, 2, 0, 75,311, 2, 10000
231, 2, 0, 74,307, 2, 10000
190, 2, 0, 55,247, 2, 10000
215, 2, 0, 67,284, 2, 10000
228, 2, 0, 51,281, 2, 10000
206, 2, 0, 59,267, 2, 10000
220, 2, 0, 50,272, 2, 10000
208, 2, 0, 55,265, 2, 10000
211, 2, 0, 61,274, 2, 10000
216, 2, 0, 47,265, 2, 10000
203, 2, 0, 75,280, 2, 10000
195, 2, 0, 58,255, 2, 10000
202, 2, 0, 62,266, 2, 10000
226, 2, 0, 50,278, 2, 10000
231, 2, 0, 49,282, 2, 10000
245, 2, 0, 47,294, 2, 10000
201, 2, 0, 64,267, 2, 10000
228, 2, 0, 60,290, 2, 10000
189, 2, 0, 60,251, 2, 10000
231, 2, 0, 47,280, 2, 10000
206, 2, 0, 60,268, 2, 10000
204, 2, 0, 46,252, 2, 10000
206, 2, 0, 53,261, 2, 10000
206, 2, 0, 49,257, 2, 10000
208, 2, 0, 63,273, 2, 10000
225, 2, 0, 42,269, 2, 10000
216, 2, 0, 56,274, 2, 10000
235, 2, 0, 67,304, 2, 10000
212, 2, 0, 55,269, 2, 10000
199, 2, 0, 55,256, 2, 10000
207, 2, 0, 55,264, 2, 10000
215, 2, 0, 56,273, 2, 10000
212, 2, 0, 50,264, 2, 10000
218, 2, 0, 47,267, 2, 10000
181, 2, 0, 55,238, 2, 10000
204, 2, 0, 50,256, 2, 10000
199, 2, 0, 67,268, 2, 10000
183, 2, 0, 51,236, 2, 10000
204, 2, 0, 59,265, 2, 10000
187, 2, 0, 46,235, 2, 10000
207, 2, 0, 49,258, 2, 10000
219, 2, 0, 71,292, 2, 10000
197, 2, 0, 51,250, 2, 10000
205, 2, 0, 50,257, 2, 10000
203, 2, 0, 54,259, 2, 10000
198, 2, 0, 63,263, 2, 10000
203, 2, 0, 49,254, 2, 10000
203, 2, 0, 61,266, 2, 10000
178, 2, 0, 54,234, 2, 10000
205, 2, 0, 35,242, 2, 10000
180, 2, 0, 59,241, 2, 10000
200, 2, 0, 51,253, 2, 10000
201, 2, 0, 62,265, 2, 10000
185, 2, 0, 57,244, 2, 10000
210, 2, 0, 66,278, 2, 10000
195, 2, 0, 50,247, 2, 10000
208, 2, 0, 52,262, 2, 10000
183, 2, 0, 52,237, 2, 10000
203, 2, 0, 49,254, 2, 10000
175, 2, 0, 51,228, 2, 10000
205, 2, 0, 53,260, 2, 10000
202, 2, 0, 51,255, 2, 10000
193, 2, 0, 55,250, 2, 10000
180, 2, 0, 45,227, 2, 10000
206, 2, 0, 62,270, 2, 10000
188, 2, 0, 60,250, 2, 10000
160, 2, 0, 42,204, 2, 10000
181, 2, 0, 41,224, 2, 10000
163, 2, 0, 48,213, 2, 10000
165, 2, 0, 39,206, 2, 10000
171, 2, 0, 49,222, 2, 10000
214, 2, 0, 42,258, 2, 10000
149, 2, 0, 36,187, 2, 10000
180, 2, 0, 44,226, 2, 10000
163, 2, 0, 40,205, 2, 10000
200, 2, 0, 43,245, 2, 10000
204, 2, 0, 56,262, 2, 10000
193, 2, 0, 51,246, 2, 10000
177, 2, 0, 57,236, 2, 10000
208, 2, 0, 44,254, 2, 10000
181, 2, 0, 61,244, 2, 10000
186, 2, 0, 48,236, 2, 10000
173, 2, 0, 48,223, 2, 10000
174, 2, 0, 48,224, 2, 10000
188, 2, 0, 49,239, 2, 10000
197, 2, 0, 60,259, 2, 10000
194, 2, 0, 57,253, 2, 10000
186, 2, 0, 56,244, 2, 10000
193, 2, 0, 42,237, 2, 10000
196, 2, 0, 52,250, 2, 10000
183, 2, 0, 43,228, 2, 10000
170, 2, 0, 43,215, 2, 10000
170, 2, 0, 53,225, 2, 10000
177, 2, 0, 49,228, 2, 10000
159, 2, 0, 40,201, 2, 10000
177, 2, 0, 38,217, 2, 10000
182, 2, 0, 44,228, 2, 10000
187, 2, 0, 37,226, 2, 10000
163, 2, 0, 43,208, 2, 10000
172, 2, 0, 50,224, 2, 10000
168, 2, 0, 48,218, 2, 10000
157, 2, 0, 59,218, 2, 10000
151, 2, 0, 47,200, 2, 10000
188, 2, 0, 47,237, 2, 10000
191, 2, 0, 38,231, 2, 10000
175, 2, 0, 46,223, 2, 10000
190, 2, 0, 50,242, 2, 10000
186, 2, 0, 53,241, 2, 10000
182, 2, 0, 34,218, 2, 10000
166, 2, 0, 59,227, 2, 10000
173, 2, 0, 33,208, 2, 10000
152, 2, 0, 41,195, 2, 10000
196, 2, 0, 43,241, 2, 10000
149, 2, 0, 59,210, 2, 10000
168, 2, 0, 56,226, 2, 10000
156, 2, 0, 52,210, 2, 10000
167, 2, 0, 60,229, 2, 10000
168, 2, 0, 31,201, 2, 10000
159, 2, 0, 39,200, 2, 10000
172, 2, 0, 40,214, 2, 10000
152, 2, 0, 56,210, 2, 10000
162, 2, 0, 42,206, 2, 10000
187, 2, 0, 42,231, 2, 10000
190, 2, 0, 49,241, 2, 10000
172, 2, 0, 62,236, 2, 10000
165, 2, 0, 42,209, 2, 10000
170, 2, 0, 43,215, 2, 10000
183, 2, 0, 44,229, 2, 10000
176, 2, 0, 37,215, 2, 10000
160, 2, 0, 57,219, 2, 10000
175, 2, 0, 47,224, 2, 10000
167, 2, 0, 35,204, 2, 10000
166, 2, 0, 44,212, 2, 10000
152, 2, 0, 45,199, 2, 10000
169, 2, 0, 49,220, 2, 10000
159, 2, 0, 45,206, 2, 10000
175, 2, 0, 55,232, 2, 10000
141, 2, 0, 54,197, 2, 10000
160, 2, 0, 58,220, 2, 10000
183, 2, 0, 41,226, 2, 10000
161, 2, 0, 43,206, 2, 10000
157, 2, 0, 57,216, 2, 10000
170, 2, 0, 47,219, 2, 10000
157, 2, 0, 43,202, 2, 10000
159, 2, 0, 36,197, 2, 10000
160, 2, 0, 44,206, 2, 10000
175, 2, 0, 56,233, 2, 10000
164, 2, 0, 46,212, 2, 10000
179, 2, 0, 40,221, 2, 10000
158, 2, 0, 44,204, 2, 10000
163, 2, 0, 46,211, 2, 10000
166, 2, 0, 33,201, 2, 10000
167, 2, 0, 41,210, 2, 10000
143, 2, 0, 45,190, 2, 10000
152, 2, 0, 27,181, 2, 10000
155, 2, 0, 48,205, 2, 10000
152, 2, 0, 43,197, 2, 10000
152, 2, 0, 37,191, 2, 10000
148, 2, 0, 36,186, 2, 10000
152, 2, 0, 39,193, 2, 10000
145, 2, 0, 37,184, 2, 10000
165, 2, 0, 49,216, 2, 10000
168, 2, 0, 40,210, 2, 10000
150, 2, 0, 48,200, 2, 10000
157, 2, 0, 29,188, 2, 10000
154, 2, 0, 42,198, 2, 10000
141, 2, 0, 37,180, 2, 10000
144, 2, 0, 32,178, 2, 10000
152, 2, 0, 46,200, 2, 10000
151, 2, 0, 40,193, 2, 10000
146, 2, 0, 47,195, 2, 10000
183, 2, 0, 41,226, 2, 10000
142, 2, 0, 47,191, 2, 10000
140, 2, 0, 44,186, 2, 10000
160, 2, 0, 39,201, 2, 10000
156, 2, 0, 40,198, 2, 10000
155, 2, 0, 40,197, 2, 10000
137, 2, 0, 41,180, 2, 10000
148, 2, 0, 46,196, 2, 10000
150, 2, 0, 34,186, 2, 10000
155, 2, 0, 44,201, 2, 10000
139, 2, 0, 56,197, 2, 10000
143, 2, 0, 32,177, 2, 10000
145, 2, 0, 36,183, 2, 10000
157, 2, 0, 52,211, 2, 10000
143, 2, 0, 47,192, 2, 10000
135, 2, 0, 46,183, 2, 10000
145, 2, 0, 44,191, 2, 10000
107, 2, 0, 38,147, 2, 10000
158, 2, 0, 49,209, 2, 10000
148, 2, 0, 35,185, 2, 10000
152, 2, 0, 31,185, 2, 10000
132, 2, 0, 41,175, 2, 10000
155, 2, 0, 36,193, 2, 10000
155, 2, 0, 43,200, 2, 10000
164, 2, 0, 36,202, 2, 10000
171, 2, 0, 44,217, 2, 10000
147, 2, 0, 32,181, 2, 10000
154, 2, 0, 41,197, 2, 10000
148, 2, 0, 47,197, 2, 10000
138, 2, 0, 43,183, 2, 10000
146, 2, 0, 42,190, 2, 10000
146, 2, 0, 37,185, 2, 10000
157, 2, 0, 40,199, 2, 10000
160, 2, 0, 39,201, 2, 10000
154, 2, 0, 36,192, 2, 10000
159, 2, 0, 41,202, 2, 10000
124, 2, 0, 42,168, 2, 10000
157, 2, 0, 40,199, 2, 10000
117, 2, 0, 33,152, 2, 10000
145, 2, 0, 39,186, 2, 10000
125, 2, 0, 38,165, 2, 10000
135, 2, 0, 35,172, 2, 10000
150, 2, 0, 35,187, 2, 10000
139, 2, 0, 38,179, 2, 10000
121, 2, 0, 38,161, 2, 10000
130, 2, 0, 26,158, 2, 10000
134, 2, 0, 36,172, 2, 10000
132, 2, 0, 35,169, 2, 10000
138, 2, 0, 29,169, 2, 10000
116, 2, 0, 37,155, 2, 10000
156, 2, 0, 33,191, 2, 10000
147, 2, 0, 33,182, 2, 10000
131, 2, 0, 31,164, 2, 10000
141, 2, 0, 41,184, 2, 10000
128, 2, 0, 29,159, 2, 10000
142, 2, 0, 40,184, 2, 10000
137, 2, 0, 35,174, 2, 10000
135, 2, 0, 46,183, 2, 10000
133, 2, 0, 36,171, 2, 10000
125, 2, 0, 41,168, 2, 10000
128, 2, 0, 46,176, 2, 10000
141, 2, 0, 25,168, 2, 10000
140, 2, 0, 45,187, 2, 10000
126, 2, 0, 40,168, 2, 10000
119, 2, 0, 30,151, 2, 10000
149, 2, 0, 45,196, 2, 10000
141, 2, 0, 38,181, 2, 10000
138, 2, 0, 37,177, 2, 10000
111, 2, 0, 41,154, 2, 10000
134, 2, 0, 37,173, 2, 10000
157, 2, 0, 46,205, 2, 10000
127, 2, 0, 37,166, 2, 10000
137, 2, 0, 36,175, 2, 10000
119, 2, 0, 34,155, 2, 10000
114, 2, 0, 42,158, 2, 10000
133, 2, 0, 33,168, 2, 10000
117, 2, 0, 41,160, 2, 10000
127, 2, 0, 22,151, 2, 10000
139, 2, 0, 30,171, 2, 10000
133, 2, 0, 37,172, 2, 10000
123, 2, 0, 41,166, 2, 10000
108, 2, 0, 44,154, 2, 10000
135, 2, 0, 40,177, 2, 10000
123, 2, 0, 29,154, 2, 10000
126, 2, 0, 44,172, 2, 10000
130, 2, 0, 31,163, 2, 10000
148, 2, 0, 40,190, 2, 10000
137, 2, 0, 37,176, 2, 10000
118, 2, 0, 33,153, 2, 10000
127, 2, 0, 33,162, 2, 10000
122, 2, 0, 39,163, 2, 10000
146, 2, 0, 32,180, 2, 10000
142, 2, 0, 29,173, 2, 10000
132, 2, 0, 38,172, 2, 10000
135, 2, 0, 36,173, 2, 10000
148, 2, 0, 27,177, 2, 10000
136, 2, 0, 32,170, 2, 10000
140, 2, 0, 45,187, 2, 10000
131, 2, 0, 31,164, 2, 10000
154, 2, 0, 31,187, 2, 10000
147, 2, 0, 36,185, 2, 10000
121, 2, 0, 41,164, 2, 10000
129, 2, 0, 44,175, 2, 10000
133, 2, 0, 34,169, 2, 10000
105, 2, 0, 36,143, 2, 10000
118, 2, 0, 44,164, 2, 10000
115, 2, 0, 31,148, 2, 10000
99, 2, 0, 25,126, 2, 10000
132, 2, 0, 39,173, 2, 10000
111, 2, 0, 34,147, 2, 10000
123, 2, 0, 40,165, 2, 10000
109, 2, 0, 42,153, 2, 10000
112, 2, 0, 37,151, 2, 10000
128, 2, 0, 21,151, 2, 10000
127, 2, 0, 23,152, 2, 10000
106, 2, 0, 32,140, 2, 10000
134, 2, 0, 32,168, 2, 10000
107, 2, 0, 37,146, 2, 10000
138, 2, 0, 35,175, 2, 10000
116, 2, 0, 32,150, 2, 10000
118, 2, 0, 33,153, 2, 10000
114, 2, 0, 21,137, 2, 10000
123, 2, 0, 24,149, 2, 10000
112, 2, 0, 45,159, 2, 10000
135, 2, 0, 32,169, 2, 10000
127, 2, 0, 28,157, 2, 10000
119, 2, 0, 29,150, 2, 10000
127, 2, 0, 36,165, 2, 10000
90, 2, 0, 34,126, 2, 10000
118, 2, 0, 37,157, 2, 10000
137, 2, 0, 41,180, 2, 10000
136, 2, 0, 35,173, 2, 10000
118, 2, 0, 31,151, 2, 10000
127, 2, 0, 29,158, 2, 10000
131, 2, 0, 38,171, 2, 10000
135, 2, 0, 26,163, 2, 10000
113, 2, 0, 38,153, 2, 10000
125, 2, 0, 34,161, 2, 10000
112, 2, 0, 31,145, 2, 10000
117, 2, 0, 29,148, 2, 10000
102, 2, 0, 29,133, 2, 10000
127, 2, 0, 25,154, 2, 10000
99, 2, 0, 31,132, 2, 10000
142, 2, 0, 27,171, 2, 10000
123, 2, 0, 30,155, 2, 10000
122, 2, 0, 29,153, 2, 10000
110, 2, 0, 35,147, 2, 10000
130, 2, 0, 35,167, 2, 10000
118, 2, 0, 27,147, 2, 10000
127, 2, 0, 42,171, 2, 10000
114, 2, 0, 35,151, 2, 10000
112, 2, 0, 25,139, 2, 10000
110, 2, 0, 31,143, 2, 10000
117, 2, 0, 39,158, 2, 10000
108, 2, 0, 33,143, 2, 10000
126, 2, 0, 33,161, 2, 10000
142, 2, 0, 35,179, 2, 10000
130, 2, 0, 32,164, 2, 10000
119, 2, 0, 40,161, 2, 10000
104, 2, 0, 30,136, 2, 10000
104, 2, 0, 32,138, 2, 10000
115, 2, 0, 30,147, 2, 10000
112, 2, 0, 21,135, 2, 10000
114, 2, 0, 20,136, 2, 10000
122, 2, 0, 37,161, 2, 10000
109, 2, 0, 35,146, 2, 10000
111, 2, 0, 17,130, 2, 10000
116, 2, 0, 23,141, 2, 10000
117, 2, 0, 44,163, 2, 10000
100, 2, 0, 36,138, 2, 10000
126, 2, 0, 37,165, 2, 10000
114, 2, 0, 36,152, 2, 10000
84, 2, 0, 38,124, 2, 10000
92, 2, 0, 35,129, 2, 10000
109, 2, 0, 34,145, 2, 10000
120, 2, 0, 26,148, 2, 10000
96, 2, 0, 31,129, 2, 10000
102, 2, 0, 28,132, 2, 10000
112, 2, 0, 35,149, 2, 10000
110, 2, 0, 34,146, 2, 10000
100, 2, 0, 34,136, 2, 10000
111, 2, 0, 40,153, 2, 10000
112, 2, 0, 30,144, 2, 10000
125, 2, 0, 43,170, 2, 10000
122, 2, 0, 30,154, 2, 10000
98, 2, 0, 33,133, 2, 10000
105, 2, 0, 35,142, 2, 10000
108, 2, 0, 32,142, 2, 10000
118, 2, 0, 31,151, 2, 10000
109, 2, 0, 33,144, 2, 10000
112, 2, 0, 28,142, 2, 10000
107, 2, 0, 26,135, 2, 10000
111, 2, 0, 35,148, 2, 10000
91, 2, 0, 35,128, 2, 10000
120, 2, 0, 27,149, 2, 10000
109, 2, 0, 25,136, 2, 10000
111, 2, 0, 32,145, 2, 10000
102, 2, 0, 26,130, 2, 10000
126, 2, 0, 30,158, 2, 10000
120, 2, 0, 30,152, 2, 10000
112, 2, 0, 30,144, 2, 10000
101, 2, 0, 28,131, 2, 10000
96, 2, 0, 29,127, 2, 10000
106, 2, 0, 30,138, 2, 10000
121, 2, 0, 38,161, 2, 10000
131, 2, 0, 30,163, 2, 10000
103, 2, 0, 38,143, 2, 10000
137, 2, 0, 22,161, 2, 10000
105, 2, 0, 34,141, 2, 10000
106, 2, 0, 29,137, 2, 10000
108, 2, 0, 32,142, 2, 10000
85, 2, 0, 18,105, 2, 10000
122, 2, 0, 37,161, 2, 10000
111, 2, 0, 28,141, 2, 10000
105, 2, 0, 27,134, 2, 10000
117, 2, 0, 28,147, 2, 10000
102, 2, 0, 27,131, 2, 10000
109, 2, 0, 34,145, 2, 10000
104, 2, 0, 36,142, 2, 10000
94, 2, 0, 20,116, 2, 10000
90, 2, 0, 31,123, 2, 10000
104, 2, 0, 33,139, 2, 10000
97, 2, 0, 31,130, 2, 10000
103, 2, 0, 32,137, 2, 10000
118, 2, 0, 37,157, 2, 10000
107, 2, 0, 30,139, 2, 10000
105, 2, 0, 31,138, 2, 10000
90, 2, 0, 36,128, 2, 10000
101, 2, 0, 32,135, 2, 10000
96, 2, 0, 24,122, 2, 10000
104, 2, 0, 38,144, 2, 10000
91, 2, 0, 26,119, 2, 10000
104, 2, 0, 25,131, 2, 10000
101, 2, 0, 23,126, 2, 10000
104, 2, 0, 25,131, 2, 10000
113, 2, 0, 22,137, 2, 10000
114, 2, 0, 30,146, 2, 10000
93, 2, 0, 22,117, 2, 10000
104, 2, 0, 32,138, 2, 10000
107, 2, 0, 45,154, 2, 10000
111, 2, 0, 27,140, 2, 10000
79, 2, 0, 35,116, 2, 10000
89, 2, 0, 31,122, 2, 10000
102, 2, 0, 31,135, 2, 10000
93, 2, 0, 26,121, 2, 10000
113, 2, 0, 36,151, 2, 10000
101, 2, 0, 31,134, 2, 10000
97, 2, 0, 22,121, 2, 10000
97, 2, 0, 23,122, 2, 10000
96, 2, 0, 25,123, 2, 10000
92, 2, 0, 27,121, 2, 10000
99, 2, 0, 28,129, 2, 10000
96, 2, 0, 29,127, 2, 10000
98, 2, 0, 19,119, 2, 10000
99, 2, 0, 28,129, 2, 10000
98, 2, 0, 24,124, 2, 10000
105, 2, 0, 30,137, 2, 10000
103, 2, 0, 31,136, 2, 10000
90, 2, 0, 19,111, 2, 10000
101, 2, 0, 30,133, 2, 10000
109, 2, 0, 28,139, 2, 10000
82, 2, 0, 24,108, 2, 10000
114, 2, 0, 32,148, 2, 10000
105, 2, 0, 30,137, 2, 10000
93, 2, 0, 23,118, 2, 10000
108, 2, 0, 44,154, 2, 10000
84, 2, 0, 31,117, 2, 10000
92, 2, 0, 19,113, 2, 10000
89, 2, 0, 22,113, 2, 10000
92, 2, 0, 23,117, 2, 10000
94, 2, 0, 20,116, 2, 10000
96, 2, 0, 21,119, 2, 10000
92, 2, 0, 24,118, 2, 10000
130, 2, 0, 31,163, 2, 10000
82, 2, 0, 30,114, 2, 10000
99, 2, 0, 22,123, 2, 10000
87, 2, 0, 30,119, 2, 10000
96, 2, 0, 22,120, 2, 10000
120, 2, 0, 37,159, 2, 10000
101, 2, 0, 21,124, 2, 10000
82, 2, 0, 24,108, 2, 10000
99, 2, 0, 29,130, 2, 10000
102, 2, 0, 28,132, 2, 10000
102, 2, 0, 26,130, 2, 10000
82, 2, 0, 18,102, 2, 10000
73, 2, 0, 20,95, 2, 10000
91, 2, 0, 26,119, 2, 10000
90, 2, 0, 28,120, 2, 10000
92, 2, 0, 27,121, 2, 10000
100, 2, 0, 22,124, 2, 10000
87, 2, 0, 24,113, 2, 10000
80, 2, 0, 34,116, 2, 10000
94, 2, 0, 24,120, 2, 10000
95, 2, 0, 25,122, 2, 10000
102, 2, 0, 31,135, 2, 10000
101, 2, 0, 19,122, 2, 10000
90, 2, 0, 22,114, 2, 10000
91, 2, 0, 22,115, 2, 10000
96, 2, 0, 34,132, 2, 10000
97, 2, 0, 24,123, 2, 10000
109, 2, 0, 30,141, 2, 10000
84, 2, 0, 23,109, 2, 10000
109, 2, 0, 22,133, 2, 10000
99, 2, 0, 29,130, 2, 10000
86, 2, 0, 36,124, 2, 10000
101, 2, 0, 25,128, 2, 10000
110, 2, 0, 29,141, 2, 10000
107, 2, 0, 24,133, 2, 10000
85, 2, 0, 29,116, 2, 10000
83, 2, 0, 23,108, 2, 10000
105, 2, 0, 37,144, 2, 10000
98, 2, 0, 37,137, 2, 10000
89, 2, 0, 21,112, 2, 10000
84, 2, 0, 26,112, 2, 10000
97, 2, 0, 28,127, 2, 10000
106, 2, 0, 23,131, 2, 10000
97, 2, 0, 23,122, 2, 10000
102, 2, 0, 22,126, 2, 10000
92, 2, 0, 22,116, 2, 10000
88, 2, 0, 34,124, 2, 10000
91, 2, 0, 27,120, 2, 10000
92, 2, 0, 21,115, 2, 10000
92, 2, 0, 27,121, 2, 10000
114, 2, 0, 28,144, 2, 10000
97, 2, 0, 18,117, 2, 10000
80, 2, 0, 19,101, 2, 10000
98, 2, 0, 20,120, 2, 10000
89, 2, 0, 26,117, 2, 10000
99, 2, 0, 26,127, 2, 10000
81, 2, 0, 20,103, 2, 10000
73, 2, 0, 24,99, 2, 10000
96, 2, 0, 34,132, 2, 10000
105, 2, 0, 22,129, 2, 10000
83, 2, 0, 28,113, 2, 10000
95, 2, 0, 15,112, 2, 10000
85, 2, 0, 28,115, 2, 10000
96, 2, 0, 31,129, 2, 10000
92, 2, 0, 26,120, 2, 10000
97, 2, 0, 29,128, 2, 10000
95, 2, 0, 22,119, 2, 10000
76, 2, 0, 25,103, 2, 10000
82, 2, 0, 15,99, 2, 10000
100, 2, 0, 30,132, 2, 10000
78, 2, 0, 26,106, 2, 10000
91, 2, 0, 29,122, 2, 10000
83, 2, 0, 21,106, 2, 10000
96, 2, 0, 26,124, 2, 10000
71, 2, 0, 34,107, 2, 10000
86, 2, 0, 23,111, 2, 10000
95, 2, 0, 15,112, 2, 10000
83, 2, 0, 19,104, 2, 10000
94, 2, 0, 14,110, 2, 10000
83, 2, 0, 29,114, 2, 10000
92, 2, 0, 26,120, 2, 10000
82, 2, 0, 29,113, 2, 10000
94, 2, 0, 16,112, 2, 10000
85, 2, 0, 27,114, 2, 10000
92, 2, 0, 25,119, 2, 10000
90, 2, 0, 23,115, 2, 10000
90, 2, 0, 22,114, 2, 10000
85, 2, 0, 20,107, 2, 10000
104, 2, 0, 24,130, 2, 10000
90, 2, 0, 23,115, 2, 10000
89, 2, 0, 31,122, 2, 10000
110, 2, 0, 20,132, 2, 10000
82, 2, 0, 30,114, 2, 10000
89, 2, 0, 31,122, 2, 10000
99, 2, 0, 30,131, 2, 10000
92, 2, 0, 24,118, 2, 10000
100, 2, 0, 23,125, 2, 10000
75, 2, 0, 29,106, 2, 10000
85, 2, 0, 21,108, 2, 10000
84, 2, 0, 28,114, 2, 10000
86, 2, 0, 23,111, 2, 10000
94, 2, 0, 23,119, 2, 10000
103, 2, 0, 24,129, 2, 10000
79, 2, 0, 25,106, 2, 10000
73, 2, 0, 22,97, 2, 10000
72, 2, 0, 29,103, 2, 10000
98, 2, 0, 17,117, 2, 10000
87, 2, 0, 26,115, 2, 10000
97, 2, 0, 33,132, 2, 10000
90, 2, 0, 29,121, 2, 10000
101, 2, 0, 16,119, 2, 10000
106, 2, 0, 28,136, 2, 10000
73, 2, 0, 21,96, 2, 10000
84, 2, 0, 18,104, 2, 10000
75, 2, 0, 25,102, 2, 10000
91, 2, 0, 23,116, 2, 10000
77, 2, 0, 18,97, 2, 10000
94, 2, 0, 22,118, 2, 10000
98, 2, 0, 23,123, 2, 10000
93, 2, 0, 26,121, 2, 10000
86, 2, 0, 27,115, 2, 10000
61, 2, 0, 29,92, 2, 10000
96, 2, 0, 26,124, 2, 10000
81, 2, 0, 23,106, 2, 10000
73, 2, 0, 24,99, 2, 10000
70, 2, 0, 17,89, 2, 10000
79, 2, 0, 30,111, 2, 10000
89, 2, 0, 26,117, 2, 10000
95, 2, 0, 33,130, 2, 10000
84, 2, 0, 13,99, 2, 10000
76, 2, 0, 25,103, 2, 10000
74, 2, 0, 33,109, 2, 10000
92, 2, 0, 26,120, 2, 10000
95, 2, 0, 27,124, 2, 10000
74, 2, 0, 26,102, 2, 10000
79, 2, 0, 26,107, 2, 10000
72, 2, 0, 28,102, 2, 10000
95, 2, 0, 18,115, 2, 10000
96, 2, 0, 24,122, 2, 10000
88, 2, 0, 27,117, 2, 10000
73, 2, 0, 24,99, 2, 10000
75, 2, 0, 24,101, 2, 10000
73, 2, 0, 23,98, 2, 10000
74, 2, 0, 19,95, 2, 10000
85, 2, 0, 14,101, 2, 10000
82, 2, 0, 22,106, 2, 10000
71, 2, 0, 25,98, 2, 10000
92, 2, 0, 22,116, 2, 10000
83, 2, 0, 22,107, 2, 10000
80, 2, 0, 26,108, 2, 10000
79, 2, 0, 16,97, 2, 10000
87, 2, 0, 23,112, 2, 10000
77, 2, 0, 25,104, 2, 10000
73, 2, 0, 18,93, 2, 10000
103, 2, 0, 27,132, 2, 10000
77, 2, 0, 22,101, 2, 10000
84, 2, 0, 22,108, 2, 10000
81, 2, 0, 23,106, 2, 10000
82, 2, 0, 21,105, 2, 10000
76, 2, 0, 34,112, 2, 10000
67, 2, 0, 19,88, 2, 10000
87, 2, 0, 26,115, 2, 10000
88, 2, 0, 26,116, 2, 10000
81, 2, 0, 27,110, 2, 10000
77, 2, 0, 21,100, 2, 10000
70, 2, 0, 19,91, 2, 10000
71, 2, 0, 24,97, 2, 10000
95, 2, 0, 20,117, 2, 10000
76, 2, 0, 19,97, 2, 10000
92, 2, 0, 25,119, 2, 10000
68, 2, 0, 19,89, 2, 10000
68, 2, 0, 24,94, 2, 10000
107, 2, 0, 29,138, 2, 10000
71, 2, 0, 23,96, 2, 10000
78, 2, 0, 27,107, 2, 10000
75, 2, 0, 27,104, 2, 10000
82, 2, 0, 19,103, 2, 10000
81, 2, 0, 18,101, 2, 10000
71, 2, 0, 27,100, 2, 10000
88, 2, 0, 17,107, 2, 10000
69, 2, 0, 32,103, 2, 10000
63, 2, 0, 20,85, 2, 10000
88, 2, 0, 20,110, 2, 10000
76, 2, 0, 18,96, 2, 10000
86, 2, 0, 20,108, 2, 10000
91, 2, 0, 30,123, 2, 10000
81, 2, 0, 15,98, 2, 10000
76, 2, 0, 25,103, 2, 10000
85, 2, 0, 29,116, 2, 10000
84, 2, 0, 24,110, 2, 10000
78, 2, 0, 28,108, 2, 10000
71, 2, 0, 24,97, 2, 10000
62, 2, 0, 24,88, 2, 10000
84, 2, 0, 26,112, 2, 10000
84, 2, 0, 23,109, 2, 10000
72, 2, 0, 26,100, 2, 10000
71, 2, 0, 16,89, 2, 10000
77, 2, 0, 26,105, 2, 10000
81, 2, 0, 19,102, 2, 10000
84, 2, 0, 17,103, 2, 10000
73, 2, 0, 18,93, 2, 10000
69, 2, 0, 18,89, 2, 10000
78, 2, 0, 21,101, 2, 10000
61, 2, 0, 17,80, 2, 10000
73, 2, 0, 30,105, 2, 10000
85, 2, 0, 24,111, 2, 10000
79, 2, 0, 22,103, 2, 10000
61, 2, 0, 29,92, 2, 10000
67, 2, 0, 22,91, 2, 10000
77, 2, 0, 21,100, 2, 10000
76, 2, 0, 28,106, 2, 10000
64, 2, 0, 24,90, 2, 10000
79, 2, 0, 28,109, 2, 10000
69, 2, 0, 14,85, 2, 10000
63, 2, 0, 22,87, 2, 10000
80, 2, 0, 25,107, 2, 10000
89, 2, 0, 15,106, 2, 10000
71, 2, 0, 24,97, 2, 10000
81, 2, 0, 29,112, 2, 10000
72, 2, 0, 22,96, 2, 10000
59, 2, 0, 21,82, 2, 10000
82, 2, 0, 21,105, 2, 10000
94, 2, 0, 25,121, 2, 10000
74, 2, 0, 26,102, 2, 10000
86, 2, 0, 17,105, 2, 10000
74, 2, 0, 20,96, 2, 10000
54, 2, 0, 20,76, 2, 10000
71, 2, 0, 24,97, 2, 10000
69, 2, 0, 26,97, 2, 10000
84, 2, 0, 19,105, 2, 10000
77, 2, 0, 19,98, 2, 10000
71, 2, 0, 26,99, 2, 10000
73, 2, 0, 22,97, 2, 10000
76, 2, 0, 18,96, 2, 10000
69, 2, 0, 19,90, 2, 10000
71, 2, 0, 17,90, 2, 10000
82, 2, 0, 24,108, 2, 10000
79, 2, 0, 23,104, 2, 10000
78, 2, 0, 14,94, 2, 10000
68, 2, 0, 18,88, 2, 10000
77, 2, 0, 26,105, 2, 10000
72, 2, 0, 17,91, 2, 10000
61, 2, 0, 19,82, 2, 10000
74, 2, 0, 20,96, 2, 10000
63, 2, 0, 22,87, 2, 10000
66, 2, 0, 16,84, 2, 10000
80, 2, 0, 18,100, 2, 10000
77, 2, 0, 23,102, 2, 10000
75, 2, 0, 19,96, 2, 10000
93, 2, 0, 16,111, 2, 10000
69, 2, 0, 15,86, 2, 10000
59, 2, 0, 19,80, 2, 10000
65, 2, 0, 15,82, 2, 10000
76, 2, 0, 16,94, 2, 10000
76, 2, 0, 21,99, 2, 10000
65, 2, 0, 21,88, 2, 10000
58, 2, 0, 23,83, 2, 10000
83, 2, 0, 18,103, 2, 10000
90, 2, 0, 17,109, 2, 10000
67, 2, 0, 22,91, 2, 10000
74, 2, 0, 17,93, 2, 10000
73, 2, 0, 26,101, 2, 10000
69, 2, 0, 18,89, 2, 10000
81, 2, 0, 30,113, 2, 10000
76, 2, 0, 24,102, 2, 10000
60, 2, 0, 18,80, 2, 10000
76, 2, 0, 20,98, 2, 10000
73, 2, 0, 20,95, 2, 10000
71, 2, 0, 23,96, 2, 10000
78, 2, 0, 23,103, 2, 10000
71, 2, 0, 21,94, 2, 10000
75, 2, 0, 34,111, 2, 10000
76, 2, 0, 15,93, 2, 10000
79, 2, 0, 22,103, 2, 10000
76, 2, 0, 27,105, 2, 10000
70, 2, 0, 19,91, 2, 10000
78, 2, 0, 17,97, 2, 10000
62, 2, 0, 20,84, 2, 10000
66, 2, 0, 31,99, 2, 10000
55, 2, 0, 23,80, 2, 10000
75, 2, 0, 21,98, 2, 10000
68, 2, 0, 16,86, 2, 10000
76, 2, 0, 18,96, 2, 10000
61, 2, 0, 17,80, 2, 10000
74, 2, 0, 22,98, 2, 10000
60, 2, 0, 15,77, 2, 10000
64, 2, 0, 24,90, 2, 10000
58, 2, 0, 20,80, 2, 10000
81, 2, 0, 9,92, 2, 10000
59, 2, 0, 27,88, 2, 10000
68, 2, 0, 19,89, 2, 10000
69, 2, 0, 28,99, 2, 10000
83, 2, 0, 20,105, 2, 10000
78, 2, 0, 23,103, 2, 10000
77, 2, 0, 25,104, 2, 10000
77, 2, 0, 21,100, 2, 10000
78, 2, 0, 21,101, 2, 10000
52, 2, 0, 22,76, 2, 10000
75, 2, 0, 14,91, 2, 10000
59, 2, 0, 26,87, 2, 10000
69, 2, 0, 16,87, 2, 10000
62, 2, 0, 13,77, 2, 10000
72, 2, 0, 18,92, 2, 10000
76, 2, 0, 20,98, 2, 10000
69, 2, 0, 24,95, 2, 10000
77, 2, 0, 18,97, 2, 10000
63, 2, 0, 18,83, 2, 10000
69, 2, 0, 22,93, 2, 10000
83, 2, 0, 16,101, 2, 10000
75, 2, 0, 12,89, 2, 10000
59, 2, 0, 28,89, 2, 10000
58, 2, 0, 15,75, 2, 10000
63, 2, 0, 19,84, 2, 10000
75, 2, 0, 19,96, 2, 10000
70, 2, 0, 18,90, 2, 10000
61, 2, 0, 16,79, 2, 10000
79, 2, 0, 14,95, 2, 10000
68, 2, 0, 20,90, 2, 10000
67, 2, 0, 21,90, 2, 10000
71, 2, 0, 17,90, 2, 10000
81, 2, 0, 20,103, 2, 10000
65, 2, 0, 15,82, 2, 10000
61, 2, 0, 18,81, 2, 10000
73, 2, 0, 26,101, 2, 10000
72, 2, 0, 18,92, 2, 10000
72, 2, 0, 18,92, 2, 10000
54, 2, 0, 19,75, 2, 10000
66, 2, 0, 21,89, 2, 10000
73, 2, 0, 19,94, 2, 10000
67, 2, 0, 9,78, 2, 10000
79, 2, 0, 16,97, 2, 10000
62, 2, 0, 20,84, 2, 10000
81, 2, 0, 16,99, 2, 10000
57, 2, 0, 26,85, 2, 10000
75, 2, 0, 25,102, 2, 10000
77, 2, 0, 14,93, 2, 10000
75, 2, 0, 20,97, 2, 10000
84, 2, 0, 16,102, 2, 10000
72, 2, 0, 16,90, 2, 10000
80, 2, 0, 17,99, 2, 10000
59, 2, 0, 24,85, 2, 10000
76, 2, 0, 23,101, 2, 10000
62, 2, 0, 23,87, 2, 10000
63, 2, 0, 13,78, 2, 10000
52, 2, 0, 16,70, 2, 10000
79, 2, 0, 23,104, 2, 10000
67, 2, 0, 15,84, 2, 10000
62, 2, 0, 14,78, 2, 10000
59, 2, 0, 18,79, 2, 10000
63, 2, 0, 18,83, 2, 10000
68, 2, 0, 25,95, 2, 10000
79, 2, 0, 21,102, 2, 10000
67, 2, 0, 15,84, 2, 10000
66, 2, 0, 18,86, 2, 10000
78, 2, 0, 12,92, 2, 10000
83, 2, 0, 17,102, 2, 10000
62, 2, 0, 31,95, 2, 10000
77, 2, 0, 18,97, 2, 10000
64, 2, 0, 23,89, 2, 10000
63, 2, 0, 14,79, 2, 10000
63, 2, 0, 28,93, 2, 10000
57, 2, 0, 18,77, 2, 10000
54, 2, 0, 16,72, 2, 10000
63, 2, 0, 23,88, 2, 10000
62, 2, 0, 19,83, 2, 10000
61, 2, 0, 20,83, 2, 10000
51, 2, 0, 21,74, 2, 10000
62, 2, 0, 21,85, 2, 10000
63, 2, 0, 21,86, 2, 10000
63, 2, 0, 15,80, 2, 10000
65, 2, 0, 19,86, 2, 10000
57, 2, 0, 27,86, 2, 10000
82, 2, 0, 15,99, 2, 10000
68, 2, 0, 16,86, 2, 10000
78, 2, 0, 26,106, 2, 10000
71, 2, 0, 19,92, 2, 10000
55, 2, 0, 24,81, 2, 10000
69, 2, 0, 10,81, 2, 10000
59, 2, 0, 22,83, 2, 10000
67, 2, 0, 17,86, 2, 10000
76, 2, 0, 15,93, 2, 10000
67, 2, 0, 20,89, 2, 10000
66, 2, 0, 19,87, 2, 10000
58, 2, 0, 21,81, 2, 10000
51, 2, 0, 12,65, 2, 10000
62, 2, 0, 13,77, 2, 10000
60, 2, 0, 20,82, 2, 10000
59, 2, 0, 13,74, 2, 10000
64, 2, 0, 21,87, 2, 10000
60, 2, 0, 16,78, 2, 10000
61, 2, 0, 19,82, 2, 10000
58, 2, 0, 18,78, 2, 10000
67, 2, 0, 15,84, 2, 10000
64, 2, 0, 14,80, 2, 10000
59, 2, 0, 13,74, 2, 10000
64, 2, 0, 24,90, 2, 10000
65, 2, 0, 13,80, 2, 10000
48, 2, 0, 16,66, 2, 10000
54, 2, 0, 12,68, 2, 10000
66, 2, 0, 16,84, 2, 10000
78, 2, 0, 19,99, 2, 10000
52, 2, 0, 11,65, 2, 10000
63, 2, 0, 14,79, 2, 10000
56, 2, 0, 20,78, 2, 10000
71, 2, 0, 25,98, 2, 10000
68, 2, 0, 11,81, 2, 10000
81, 2, 0, 20,103, 2, 10000
58, 2, 0, 26,86, 2, 10000
79, 2, 0, 17,98, 2, 10000
68, 2, 0, 21,91, 2, 10000
60, 2, 0, 18,80, 2, 10000
64, 2, 0, 21,87, 2, 10000
45, 2, 0, 21,68, 2, 10000
64, 2, 0, 21,87, 2, 10000
48, 2, 0, 21,71, 2, 10000
67, 2, 0, 20,89, 2, 10000
55, 2, 0, 15,72, 2, 10000
48, 2, 0, 6,56, 2, 10000
62, 2, 0, 23,87, 2, 10000
55, 2, 0, 12,69, 2, 10000
62, 2, 0, 20,84, 2, 10000
55, 2, 0, 21,78, 2, 10000
68, 2, 0, 21,91, 2, 10000
57, 2, 0, 15,74, 2, 10000
69, 2, 0, 14,85, 2, 10000
48, 2, 0, 18,68, 2, 10000
77, 2, 0, 26,105, 2, 10000
73, 2, 0, 19,94, 2, 10000
56, 2, 0, 19,77, 2, 10000
65, 2, 0, 17,84, 2, 10000
68, 2, 0, 17,87, 2, 10000
73, 2, 0, 16,91, 2, 10000
73, 2, 0, 22,97, 2, 10000
81, 2, 0, 16,99, 2, 10000
62, 2, 0, 21,85, 2, 10000
64, 2, 0, 12,78, 2, 10000
68, 2, 0, 17,87, 2, 10000
75, 2, 0, 15,92, 2, 10000
56, 2, 0, 19,77, 2, 10000
65, 2, 0, 18,85, 2, 10000
80, 2, 0, 17,99, 2, 10000
76, 2, 0, 19,97, 2, 10000
58, 2, 0, 12,72, 2, 10000
59, 2, 0, 15,76, 2, 10000
63, 2, 0, 25,90, 2, 10000
66, 2, 0, 15,83, 2, 10000
61, 2, 0, 17,80, 2, 10000
67, 2, 0, 16,85, 2, 10000
63, 2, 0, 23,88, 2, 10000
48, 2, 0, 18,68, 2, 10000
74, 2, 0, 18,94, 2, 10000
47, 2, 0, 15,64, 2, 10000
74, 2, 0, 19,95, 2, 10000
64, 2, 0, 17,83, 2, 10000
67, 2, 0, 22,91, 2, 10000
62, 2, 0, 20,84, 2, 10000
56, 2, 0, 15,73, 2, 10000
72, 2, 0, 21,95, 2, 10000
50, 2, 0, 17,69, 2, 10000
51, 2, 0, 15,68, 2, 10000
68, 2, 0, 15,85, 2, 10000
60, 2, 0, 13,75, 2, 10000
56, 2, 0, 11,69, 2, 10000
56, 2, 0, 18,76, 2, 10000
70, 2, 0, 15,87, 2, 10000
71, 2, 0, 18,91, 2, 10000
64, 2, 0, 12,78, 2, 10000
62, 2, 0, 13,77, 2, 10000
56, 2, 0, 14,72, 2, 10000
67, 2, 0, 18,87, 2, 10000
52, 2, 0, 12,66, 2, 10000
65, 2, 0, 8,75, 2, 10000
60, 2, 0, 17,79, 2, 10000
65, 2, 0, 17,84, 2, 10000
61, 2, 0, 21,84, 2, 10000
53, 2, 0, 17,72, 2, 10000
59, 2, 0, 18,79, 2, 10000
55, 2, 0, 17,74, 2, 10000
58, 2, 0, 16,76, 2, 10000
52, 2, 0, 10,64, 2, 10000
65, 2, 0, 10,77, 2, 10000
51, 2, 0, 19,72, 2, 10000
56, 2, 0, 14,72, 2, 10000
47, 2, 0, 17,66, 2, 10000
64, 2, 0, 22,88, 2, 10000
55, 2, 0, 16,73, 2, 10000
49, 2, 0, 20,71, 2, 10000
38, 2, 0, 17,57, 2, 10000
61, 2, 0, 22,85, 2, 10000
65, 2, 0, 14,81, 2, 10000
47, 2, 0, 13,62, 2, 10000
56, 2, 0, 18,76, 2, 10000
58, 2, 0, 16,76, 2, 10000
58, 2, 0, 12,72, 2, 10000
47, 2, 0, 15,64, 2, 10000
39, 2, 0, 17,58, 2, 10000
65, 2, 0, 17,84, 2, 10000
55, 2, 0, 17,74, 2, 10000
66, 2, 0, 16,84, 2, 10000
77, 2, 0, 19,98, 2, 10000
42, 2, 0, 11,55, 2, 10000
57, 2, 0, 13,72, 2, 10000
53, 2, 0, 17,72, 2, 10000
63, 2, 0, 20,85, 2, 10000
43, 2, 0, 22,67, 2, 10000
48, 2, 0, 22,72, 2, 10000
59, 2, 0, 18,79, 2, 10000
61, 2, 0, 12,75, 2, 10000
50, 2, 0, 19,71, 2, 10000
51, 2, 0, 18,71, 2, 10000
65, 2, 0, 16,83, 2, 10000
67, 2, 0, 12,81, 2, 10000
62, 2, 0, 22,86, 2, 10000
64, 2, 0, 13,79, 2, 10000
60, 2, 0, 9,71, 2, 10000
54, 2, 0, 15,71, 2, 10000
61, 2, 0, 18,81, 2, 10000
63, 2, 0, 11,76, 2, 10000
63, 2, 0, 13,78, 2, 10000
55, 2, 0, 10,67, 2, 10000
48, 2, 0, 18,68, 2, 10000
55, 2, 0, 21,78, 2, 10000
50, 2, 0, 16,68, 2, 10000
67, 2, 0, 12,81, 2, 10000
66, 2, 0, 17,85, 2, 10000
60, 2, 0, 14,76, 2, 10000
68, 2, 0, 20,90, 2, 10000
64, 2, 0, 15,81, 2, 10000
41, 2, 0, 18,61, 2, 10000
64, 2, 0, 18,84, 2, 10000
48, 2, 0, 20,70, 2, 10000
61, 2, 0, 17,80, 2, 10000
51, 2, 0, 18,71, 2, 10000
71, 2, 0, 15,88, 2, 10000
57, 2, 0, 18,77, 2, 10000
55, 2, 0, 12,69, 2, 10000
59, 2, 0, 8,69, 2, 10000
59, 2, 0, 16,77, 2, 10000
50, 2, 0, 18,70, 2, 10000
64, 2, 0, 13,79, 2, 10000
56, 2, 0, 14,72, 2, 10000
44, 2, 0, 15,61, 2, 10000
58, 2, 0, 14,74, 2, 10000
56, 2, 0, 22,80, 2, 10000
64, 2, 0, 13,79, 2, 10000
62, 2, 0, 18,82, 2, 10000
46, 2, 0, 19,67, 2, 10000
42, 2, 0, 15,59, 2, 10000
58, 2, 0, 16,76, 2, 10000
57, 2, 0, 12,71, 2, 10000
75, 2, 0, 17,94, 2, 10000
46, 2, 0, 22,70, 2, 10000
49, 2, 0, 14,65, 2, 10000
53, 2, 0, 21,76, 2, 10000
61, 2, 0, 18,81, 2, 10000
53, 2, 0, 16,71, 2, 10000
61, 2, 0, 19,82, 2, 10000
63, 2, 0, 21,86, 2, 10000
49, 2, 0, 15,66, 2, 10000
50, 2, 0, 19,71, 2, 10000
73, 2, 0, 27,102, 2, 10000
54, 2, 0, 26,82, 2, 10000
69, 2, 0, 20,91, 2, 10000
51, 2, 0, 11,64, 2, 10000
57, 2, 0, 16,75, 2, 10000
61, 2, 0, 25,88, 2, 10000
69, 2, 0, 11,82, 2, 10000
57, 2, 0, 17,76, 2, 10000
59, 2, 0, 11,72, 2, 10000
55, 2, 0, 18,75, 2, 10000
59, 2, 0, 11,72, 2, 10000
61, 2, 0, 12,75, 2, 10000
59, 2, 0, 18,79, 2, 10000
59, 2, 0, 17,78, 2, 10000
58, 2, 0, 17,77, 2, 10000
53, 2, 0, 20,75, 2, 10000
62, 2, 0, 22,86, 2, 10000
62, 2, 0, 14,78, 2, 10000
53, 2, 0, 14,69, 2, 10000
48, 2, 0, 11,61, 2, 10000
54, 2, 0, 16,72, 2, 10000
47, 2, 0, 14,63, 2, 10000
54, 2, 0, 12,68, 2, 10000
47, 2, 0, 18,67, 2, 10000
53, 2, 0, 16,71, 2, 10000
55, 2, 0, 17,74, 2, 10000
49, 2, 0, 18,69, 2, 10000
49, 2, 0, 13,64, 2, 10000
61, 2, 0, 14,77, 2, 10000
60, 2, 0, 12,74, 2, 10000
69, 2, 0, 11,82, 2, 10000
52, 2, 0, 16,70, 2, 10000
46, 2, 0, 20,68, 2, 10000
59, 2, 0, 25,86, 2, 10000
61, 2, 0, 12,75, 2, 10000
47, 2, 0, 12,61, 2, 10000
47, 2, 0, 11,60, 2, 10000
60, 2, 0, 16,78, 2, 10000
58, 2, 0, 17,77, 2, 10000
58, 2, 0, 18,78, 2, 10000
47, 2, 0, 20,69, 2, 10000
60, 2, 0, 16,78, 2, 10000
68, 2, 0, 16,86, 2, 10000
54, 2, 0, 14,70, 2, 10000
64, 2, 0, 17,83, 2, 10000
53, 2, 0, 17,72, 2, 10000
45, 2, 0, 13,60, 2, 10000
50, 2, 0, 21,73, 2, 10000
66, 2, 0, 18,86, 2, 10000
45, 2, 0, 15,62, 2, 10000
55, 2, 0, 11,68, 2, 10000
56, 2, 0, 12,70, 2, 10000
68, 2, 0, 16,86, 2, 10000
50, 2, 0, 19,71, 2, 10000
56, 2, 0, 9,67, 2, 10000
57, 2, 0, 21,80, 2, 10000
57, 2, 0, 18,77, 2, 10000
56, 2, 0, 14,72, 2, 10000
47, 2, 0, 7,56, 2, 10000
47, 2, 0, 12,61, 2, 10000
51, 2, 0, 16,69, 2, 10000
53, 2, 0, 10,65, 2, 10000
56, 2, 0, 14,72, 2, 10000
56, 2, 0, 16,74, 2, 10000
46, 2, 0, 10,58, 2, 10000
54, 2, 0, 14,70, 2, 10000
75, 2, 0, 11,88, 2, 10000
50, 2, 0, 15,67, 2, 10000
58, 2, 0, 20,80, 2, 10000
50, 2, 0, 12,64, 2, 10000
52, 2, 0, 15,69, 2, 10000
44, 2, 0, 19,65, 2, 10000
55, 2, 0, 26,83, 2, 10000
50, 2, 0, 20,72, 2, 10000
42, 2, 0, 13,57, 2, 10000
51, 2, 0, 12,65, 2, 10000
63, 2, 0, 18,83, 2, 10000
36, 2, 0, 10,48, 2, 10000
47, 2, 0, 9,58, 2, 10000
46, 2, 0, 19,67, 2, 10000
51, 2, 0, 13,66, 2, 10000
51, 2, 0, 18,71, 2, 10000
53, 2, 0, 16,71, 2, 10000
58, 2, 0, 13,73, 2, 10000
51, 2, 0, 23,76, 2, 10000
58, 2, 0, 13,73, 2, 10000
57, 2, 0, 9,68, 2, 10000
45, 2, 0, 13,60, 2, 10000
52, 2, 0, 19,73, 2, 10000
53, 2, 0, 15,70, 2, 10000
62, 2, 0, 17,81, 2, 10000
49, 2, 0, 14,65, 2, 10000
57, 2, 0, 17,76, 2, 10000
52, 2, 0, 20,74, 2, 10000
51, 2, 0, 20,73, 2, 10000
42, 2, 0, 13,57, 2, 10000
57, 2, 0, 16,75, 2, 10000
58, 2, 0, 18,78, 2, 10000
60, 2, 0, 12,74, 2, 10000
47, 2, 0, 14,63, 2, 10000
52, 2, 0, 16,70, 2, 10000
44, 2, 0, 20,66, 2, 10000
60, 2, 0, 14,76, 2, 10000
50, 2, 0, 12,64, 2, 10000
58, 2, 0, 12,72, 2, 10000
64, 2, 0, 10,76, 2, 10000
46, 2, 0, 16,64, 2, 10000
48, 2, 0, 16,66, 2, 10000
55, 2, 0, 20,77, 2, 10000
58, 2, 0, 15,75, 2, 10000
45, 2, 0, 10,57, 2, 10000
56, 2, 0, 11,69, 2, 10000
63, 2, 0, 19,84, 2, 10000
48, 2, 0, 12,62, 2, 10000
37, 2, 0, 20,59, 2, 10000
47, 2, 0, 14,63, 2, 10000
52, 2, 0, 9,63, 2, 10000
45, 2, 0, 11,58, 2, 10000
60, 2, 0, 19,81, 2, 10000
51, 2, 0, 10,63, 2, 10000
63, 2, 0, 13,78, 2, 10000
45, 2, 0, 9,56, 2, 10000
48, 2, 0, 5,55, 2, 10000
43, 2, 0, 22,67, 2, 10000
58, 2, 0, 10,70, 2, 10000
38, 2, 0, 22,62, 2, 10000
47, 2, 0, 14,63, 2, 10000
41, 2, 0, 15,58, 2, 10000
50, 2, 0, 8,60, 2, 10000
65, 2, 0, 15,82, 2, 10000
48, 2, 0, 22,72, 2, 10000
61, 2, 0, 15,78, 2, 10000
42, 2, 0, 13,57, 2, 10000
49, 2, 0, 11,62, 2, 10000
67, 2, 0, 16,85, 2, 10000
48, 2, 0, 13,63, 2, 10000
57, 2, 0, 26,85, 2, 10000
57, 2, 0, 16,75, 2, 10000
51, 2, 0, 17,70, 2, 10000
50, 2, 0, 12,64, 2, 10000
41, 2, 0, 19,62, 2, 10000
50, 2, 0, 15,67, 2, 10000
64, 2, 0, 11,77, 2, 10000
51, 2, 0, 24,77, 2, 10000
51, 2, 0, 13,66, 2, 10000
51, 2, 0, 13,66, 2, 10000
43, 2, 0, 10,55, 2, 10000
48, 2, 0, 22,72, 2, 10000
40, 2, 0, 16,58, 2, 10000
48, 2, 0, 17,67, 2, 10000
42, 2, 0, 11,55, 2, 10000
48, 2, 0, 14,64, 2, 10000
36, 2, 0, 17,55, 2, 10000
56, 2, 0, 15,73, 2, 10000
48, 2, 0, 9,59, 2, 10000
52, 2, 0, 14,68, 2, 10000
47, 2, 0, 18,67, 2, 10000
55, 2, 0, 12,69, 2, 10000
62, 2, 0, 19,83, 2, 10000
46, 2, 0, 15,63, 2, 10000
52, 2, 0, 15,69, 2, 10000
64, 2, 0, 19,85, 2, 10000
44, 2, 0, 16,62, 2, 10000
54, 2, 0, 15,71, 2, 10000
62, 2, 0, 9,73, 2, 10000
37, 2, 0, 14,53, 2, 10000
49, 2, 0, 22,73, 2, 10000
43, 2, 0, 16,61, 2, 10000
57, 2, 0, 11,70, 2, 10000
47, 2, 0, 17,66, 2, 10000
57, 2, 0, 13,72, 2, 10000
59, 2, 0, 16,77, 2, 10000
50, 2, 0, 10,62, 2, 10000
58, 2, 0, 21,81, 2, 10000
62, 2, 0, 19,83, 2, 10000
53, 2, 0, 14,69, 2, 10000
46, 2, 0, 13,61, 2, 10000
56, 2, 0, 17,75, 2, 10000
58, 2, 0, 3,63, 2, 10000
56, 2, 0, 13,71, 2, 10000
45, 2, 0, 17,64, 2, 10000
41, 2, 0, 17,60, 2, 10000
49, 2, 0, 11,62, 2, 10000
44, 2, 0, 13,59, 2, 10000
59, 2, 0, 10,71, 2, 10000
44, 2, 0, 13,59, 2, 10000
60, 2, 0, 18,80, 2, 10000
47, 2, 0, 9,58, 2, 10000
47, 2, 0, 18,67, 2, 10000
58, 2, 0, 20,80, 2, 10000
46, 2, 0, 10,58, 2, 10000
62, 2, 0, 17,81, 2, 10000
60, 2, 0, 12,74, 2, 10000
46, 2, 0, 9,57, 2, 10000
53, 2, 0, 13,68, 2, 10000
63, 2, 0, 15,80, 2, 10000
49, 2, 0, 11,62, 2, 10000
40, 2, 0, 16,58, 2, 10000
52, 2, 0, 14,68, 2, 10000
50, 2, 0, 11,63, 2, 10000
41, 2, 0, 17,60, 2, 10000
43, 2, 0, 23,68, 2, 10000
46, 2, 0, 11,59, 2, 10000
48, 2, 0, 14,64, 2, 10000
45, 2, 0, 17,64, 2, 10000
49, 2, 0, 17,68, 2, 10000
50, 2, 0, 14,66, 2, 10000
41, 2, 0, 16,59, 2, 10000
38, 2, 0, 12,52, 2, 10000
35, 2, 0, 16,53, 2, 10000
59, 2, 0, 6,67, 2, 10000
49, 2, 0, 15,66, 2, 10000
51, 2, 0, 9,62, 2, 10000
47, 2, 0, 16,65, 2, 10000
54, 2, 0, 11,67, 2, 10000
47, 2, 0, 17,66, 2, 10000
56, 2, 0, 10,68, 2, 10000
47, 2, 0, 14,63, 2, 10000
57, 2, 0, 17,76, 2, 10000
57, 2, 0, 15,74, 2, 10000
50, 2, 0, 17,69, 2, 10000
54, 2, 0, 12,68, 2, 10000
55, 2, 0, 6,63, 2, 10000
50, 2, 0, 18,70, 2, 10000
51, 2, 0, 23,76, 2, 10000
47, 2, 0, 8,57, 2, 10000
49, 2, 0, 11,62, 2, 10000
45, 2, 0, 20,67, 2, 10000
46, 2, 0, 14,62, 2, 10000
44, 2, 0, 12,58, 2, 10000
41, 2, 0, 21,64, 2, 10000
45, 2, 0, 8,55, 2, 10000
44, 2, 0, 13,59, 2, 10000
47, 2, 0, 16,65, 2, 10000
53, 2, 0, 10,65, 2, 10000
55, 2, 0, 14,71, 2, 10000
43, 2, 0, 13,58, 2, 10000
54, 2, 0, 14,70, 2, 10000
42, 2, 0, 17,61, 2, 10000
57, 2, 0, 12,71, 2, 10000
46, 2, 0, 15,63, 2, 10000
49, 2, 0, 13,64, 2, 10000
42, 2, 0, 13,57, 2, 10000
56, 2, 0, 10,68, 2, 10000
46, 2, 0, 14,62, 2, 10000
46, 2, 0, 19,67, 2, 10000
56, 2, 0, 10,68, 2, 10000
52, 2, 0, 14,68, 2, 10000
45, 2, 0, 7,54, 2, 10000
48, 2, 0, 16,66, 2, 10000
58, 2, 0, 13,73, 2, 10000
67, 2, 0, 12,81, 2, 10000
45, 2, 0, 19,66, 2, 10000
38, 2, 0, 6,46, 2, 10000
50, 2, 0, 16,68, 2, 10000
41, 2, 0, 4,47, 2, 10000
42, 2, 0, 17,61, 2, 10000
49, 2, 0, 10,61, 2, 10000
39, 2, 0, 15,56, 2, 10000
49, 2, 0, 18,69, 2, 10000
55, 2, 0, 12,69, 2, 10000
38, 2, 0, 16,56, 2, 10000
40, 2, 0, 14,56, 2, 10000
29, 2, 0, 13,44, 2, 10000
46, 2, 0, 16,64, 2, 10000
42, 2, 0, 8,52, 2, 10000
34, 2, 0, 16,52, 2, 10000
47, 2, 0, 10,59, 2, 10000
52, 2, 0, 18,72, 2, 10000
28, 2, 0, 17,47, 2, 10000
40, 2, 0, 8,50, 2, 10000
50, 2, 0, 15,67, 2, 10000
47, 2, 0, 8,57, 2, 10000
44, 2, 0, 22,68, 2, 10000
44, 2, 0, 11,57, 2, 10000
66, 2, 0, 18,86, 2, 10000
44, 2, 0, 13,59, 2, 10000
39, 2, 0, 11,52, 2, 10000
59, 2, 0, 12,73, 2, 10000
38, 2, 0, 10,50, 2, 10000
49, 2, 0, 9,60, 2, 10000
32, 2, 0, 16,50, 2, 10000
37, 2, 0, 18,57, 2, 10000
49, 2, 0, 11,62, 2, 10000
36, 2, 0, 19,57, 2, 10000
40, 2, 0, 9,51, 2, 10000
52, 2, 0, 19,73, 2, 10000
59, 2, 0, 17,78, 2, 10000
44, 2, 0, 11,57, 2, 10000
48, 2, 0, 18,68, 2, 10000
45, 2, 0, 18,65, 2, 10000
43, 2, 0, 15,60, 2, 10000
44, 2, 0, 4,50, 2, 10000
47, 2, 0, 14,63, 2, 10000
42, 2, 0, 15,59, 2, 10000
50, 2, 0, 16,68, 2, 10000
35, 2, 0, 7,44, 2, 10000
56, 2, 0, 12,70, 2, 10000
46, 2, 0, 13,61, 2, 10000
38, 2, 0, 14,54, 2, 10000
52, 2, 0, 13,67, 2, 10000
40, 2, 0, 7,49, 2, 10000
49, 2, 0, 17,68, 2, 10000
48, 2, 0, 11,61, 2, 10000
41, 2, 0, 13,56, 2, 10000
42, 2, 0, 12,56, 2, 10000
39, 2, 0, 11,52, 2, 10000
44, 2, 0, 10,56, 2, 10000
55, 2, 0, 17,74, 2, 10000
55, 2, 0, 15,72, 2, 10000
45, 2, 0, 8,55, 2, 10000
35, 2, 0, 11,48, 2, 10000
32, 2, 0, 22,56, 2, 10000
50, 2, 0, 20,72, 2, 10000
43, 2, 0, 14,59, 2, 10000
30, 2, 0, 12,44, 2, 10000
58, 2, 0, 14,74, 2, 10000
54, 2, 0, 7,63, 2, 10000
49, 2, 0, 9,60, 2, 10000
48, 2, 0, 16,66, 2, 10000
48, 2, 0, 23,73, 2, 10000
53, 2, 0, 22,77, 2, 10000
41, 2, 0, 13,56, 2, 10000
29, 2, 0, 12,43, 2, 10000
49, 2, 0, 11,62, 2, 10000
48, 2, 0, 12,62, 2, 10000
46, 2, 0, 6,54, 2, 10000
45, 2, 0, 13,60, 2, 10000
41, 2, 0, 14,57, 2, 10000
52, 2, 0, 14,68, 2, 10000
47, 2, 0, 11,60, 2, 10000
55, 2, 0, 19,76, 2, 10000
41, 2, 0, 19,62, 2, 10000
56, 2, 0, 11,69, 2, 10000
42, 2, 0, 9,53, 2, 10000
52, 2, 0, 7,61, 2, 10000
42, 2, 0, 16,60, 2, 10000
38, 2, 0, 10,50, 2, 10000
43, 2, 0, 16,61, 2, 10000
36, 2, 0, 9,47, 2, 10000
50, 2, 0, 16,68, 2, 10000
45, 2, 0, 10,57, 2, 10000
43, 2, 0, 17,62, 2, 10000
44, 2, 0, 8,54, 2, 10000
43, 2, 0, 15,60, 2, 10000
47, 2, 0, 18,67, 2, 10000
37, 2, 0, 15,54, 2, 10000
46, 2, 0, 15,63, 2, 10000
44, 2, 0, 13,59, 2, 10000
45, 2, 0, 14,61, 2, 10000
42, 2, 0, 7,51, 2, 10000
53, 2, 0, 9,64, 2, 10000
46, 2, 0, 11,59, 2, 10000
45, 2, 0, 17,64, 2, 10000
51, 2, 0, 14,67, 2, 10000
48, 2, 0, 15,65, 2, 10000
51, 2, 0, 17,70, 2, 10000
48, 2, 0, 11,61, 2, 10000
37, 2, 0, 9,48, 2, 10000
46, 2, 0, 14,62, 2, 10000
51, 2, 0, 17,70, 2, 10000
53, 2, 0, 17,72, 2, 10000
47, 2, 0, 14,63, 2, 10000
48, 2, 0, 11,61, 2, 10000
37, 2, 0, 7,46, 2, 10000
48, 2, 0, 10,60, 2, 10000
53, 2, 0, 14,69, 2, 10000
38, 2, 0, 15,55, 2, 10000
50, 2, 0, 12,64, 2, 10000
56, 2, 0, 17,75, 2, 10000
33, 2, 0, 9,44, 2, 10000
44, 2, 0, 9,55, 2, 10000
38, 2, 0, 10,50, 2, 10000
49, 2, 0, 16,67, 2, 10000
45, 2, 0, 18,65, 2, 10000
46, 2, 0, 16,64, 2, 10000
53, 2, 0, 17,72, 2, 10000
49, 2, 0, 15,66, 2, 10000
58, 2, 0, 14,74, 2, 10000
41, 2, 0, 13,56, 2, 10000
30, 2, 0, 8,40, 2, 10000
43, 2, 0, 15,60, 2, 10000
46, 2, 0, 18,66, 2, 10000
46, 2, 0, 13,61, 2, 10000
40, 2, 0, 17,59, 2, 10000
37, 2, 0, 14,53, 2, 10000
59, 2, 0, 12,73, 2, 10000
42, 2, 0, 12,56, 2, 10000
34, 2, 0, 14,50, 2, 10000
42, 2, 0, 12,56, 2, 10000
45, 2, 0, 7,54, 2, 10000
41, 2, 0, 16,59, 2, 10000
43, 2, 0, 13,58, 2, 10000
42, 2, 0, 15,59, 2, 10000
48, 2, 0, 14,64, 2, 10000
43, 2, 0, 16,61, 2, 10000
53, 2, 0, 14,69, 2, 10000
51, 2, 0, 8,61, 2, 10000
39, 2, 0, 16,57, 2, 10000
44, 2, 0, 14,60, 2, 10000
44, 2, 0, 17,63, 2, 10000
32, 2, 0, 13,47, 2, 10000
42, 2, 0, 17,61, 2, 10000
39, 2, 0, 12,53, 2, 10000
40, 2, 0, 8,50, 2, 10000
39, 2, 0, 11,52, 2, 10000
51, 2, 0, 13,66, 2, 10000
44, 2, 0, 9,55, 2, 10000
38, 2, 0, 5,45, 2, 10000
42, 2, 0, 8,52, 2, 10000
58, 2, 0, 16,76, 2, 10000
43, 2, 0, 14,59, 2, 10000
52, 2, 0, 13,67, 2, 10000
41, 2, 0, 14,57, 2, 10000
40, 2, 0, 10,52, 2, 10000
42, 2, 0, 11,55, 2, 10000
36, 2, 0, 16,54, 2, 10000
48, 2, 0, 12,62, 2, 10000
48, 2, 0, 8,58, 2, 10000
46, 2, 0, 8,56, 2, 10000
52, 2, 0, 12,66, 2, 10000
46, 2, 0, 15,63, 2, 10000
51, 2, 0, 15,68, 2, 10000
36, 2, 0, 8,46, 2, 10000
56, 2, 0, 12,70, 2, 10000
36, 2, 0, 12,50, 2, 10000
52, 2, 0, 5,59, 2, 10000
37, 2, 0, 11,50, 2, 10000
42, 2, 0, 9,53, 2, 10000
38, 2, 0, 10,50, 2, 10000
43, 2, 0, 11,56, 2, 10000
44, 2, 0, 14,60, 2, 10000
34, 2, 0, 10,46, 2, 10000
37, 2, 0, 10,49, 2, 10000
37, 2, 0, 15,54, 2, 10000
40, 2, 0, 12,54, 2, 10000
47, 2, 0, 7,56, 2, 10000
39, 2, 0, 9,50, 2, 10000
46, 2, 0, 14,62, 2, 10000
42, 2, 0, 8,52, 2, 10000
41, 2, 0, 9,52, 2, 10000
48, 2, 0, 10,60, 2, 10000
35, 2, 0, 7,44, 2, 10000
45, 2, 0, 17,64, 2, 10000
36, 2, 0, 13,51, 2, 10000
53, 2, 0, 6,61, 2, 10000
49, 2, 0, 7,58, 2, 10000
46, 2, 0, 13,61, 2, 10000
45, 2, 0, 9,56, 2, 10000
48, 2, 0, 13,63, 2, 10000
39, 2, 0, 24,65, 2, 10000
39, 2, 0, 16,57, 2, 10000
33, 2, 0, 12,47, 2, 10000
41, 2, 0, 8,51, 2, 10000
31, 2, 0, 15,48, 2, 10000
38, 2, 0, 7,47, 2, 10000
34, 2, 0, 9,45, 2, 10000
38, 2, 0, 26,66, 2, 10000
25, 2, 0, 11,38, 2, 10000
52, 2, 0, 14,68, 2, 10000
42, 2, 0, 16,60, 2, 10000
48, 2, 0, 13,63, 2, 10000
43, 2, 0, 6,51, 2, 10000
49, 2, 0, 10,61, 2, 10000
47, 2, 0, 9,58, 2, 10000
42, 2, 0, 13,57, 2, 10000
45, 2, 0, 9,56, 2, 10000
36, 2, 0, 14,52, 2, 10000
32, 2, 0, 10,44, 2, 10000
58, 2, 0, 12,72, 2, 10000
46, 2, 0, 12,60, 2, 10000
45, 2, 0, 9,56, 2, 10000
53, 2, 0, 17,72, 2, 10000
37, 2, 0, 14,53, 2, 10000
49, 2, 0, 16,67, 2, 10000
42, 2, 0, 14,58, 2, 10000
46, 2, 0, 14,62, 2, 10000
42, 2, 0, 9,53, 2, 10000
31, 2, 0, 14,47, 2, 10000
48, 2, 0, 7,57, 2, 10000
41, 2, 0, 13,56, 2, 10000
43, 2, 0, 11,56, 2, 10000
34, 2, 0, 14,50, 2, 10000
40, 2, 0, 16,58, 2, 10000
36, 2, 0, 10,48, 2, 10000
51, 2, 0, 10,63, 2, 10000
31, 2, 0, 7,40, 2, 10000
36, 2, 0, 8,46, 2, 10000
42, 2, 0, 9,53, 2, 10000
45, 2, 0, 13,60, 2, 10000
48, 2, 0, 10,60, 2, 10000
39, 2, 0, 8,49, 2, 10000
38, 2, 0, 10,50, 2, 10000
38, 2, 0, 17,57, 2, 10000
33, 2, 0, 9,44, 2, 10000
48, 2, 0, 8,58, 2, 10000
32, 2, 0, 13,47, 2, 10000
45, 2, 0, 8,55, 2, 10000
39, 2, 0, 10,51, 2, 10000
30, 2, 0, 10,42, 2, 10000
38, 2, 0, 8,48, 2, 10000
39, 2, 0, 12,53, 2, 10000
53, 2, 0, 8,63, 2, 10000
33, 2, 0, 17,52, 2, 10000
37, 2, 0, 16,55, 2, 10000
45, 2, 0, 14,61, 2, 10000
40, 2, 0, 11,53, 2, 10000
33, 2, 0, 11,46, 2, 10000
44, 2, 0, 10,56, 2, 10000
41, 2, 0, 11,54, 2, 10000
34, 2, 0, 13,49, 2, 10000
33, 2, 0, 15,50, 2, 10000
43, 2, 0, 13,58, 2, 10000
34, 2, 0, 14,50, 2, 10000
42, 2, 0, 17,61, 2, 10000
34, 2, 0, 11,47, 2, 10000
37, 2, 0, 9,48, 2, 10000
35, 2, 0, 12,49, 2, 10000
44, 2, 0, 14,60, 2, 10000
41, 2, 0, 7,50, 2, 10000
42, 2, 0, 10,54, 2, 10000
49, 2, 0, 12,63, 2, 10000
25, 2, 0, 7,34, 2, 10000
39, 2, 0, 7,48, 2, 10000
44, 2, 0, 5,51, 2, 10000
42, 2, 0, 14,58, 2, 10000
41, 2, 0, 11,54, 2, 10000
35, 2, 0, 10,47, 2, 10000
39, 2, 0, 9,50, 2, 10000
41, 2, 0, 8,51, 2, 10000
39, 2, 0, 12,53, 2, 10000
40, 2, 0, 9,51, 2, 10000
35, 2, 0, 9,46, 2, 10000
51, 2, 0, 16,69, 2, 10000
35, 2, 0, 4,41, 2, 10000
49, 2, 0, 6,57, 2, 10000
43, 2, 0, 13,58, 2, 10000
33, 2, 0, 15,50, 2, 10000
32, 2, 0, 10,44, 2, 10000
38, 2, 0, 10,50, 2, 10000
41, 2, 0, 13,56, 2, 10000
31, 2, 0, 10,43, 2, 10000
42, 2, 0, 12,56, 2, 10000
40, 2, 0, 13,55, 2, 10000
38, 2, 0, 11,51, 2, 10000
41, 2, 0, 8,51, 2, 10000
31, 2, 0, 13,46, 2, 10000
47, 2, 0, 10,59, 2, 10000
42, 2, 0, 12,56, 2, 10000
40, 2, 0, 7,49, 2, 10000
54, 2, 0, 8,64, 2, 10000
34, 2, 0, 9,45, 2, 10000
46, 2, 0, 15,63, 2, 10000
39, 2, 0, 11,52, 2, 10000
40, 2, 0, 8,50, 2, 10000
42, 2, 0, 12,56, 2, 10000
46, 2, 0, 15,63, 2, 10000
42, 2, 0, 13,57, 2, 10000
35, 2, 0, 12,49, 2, 10000
32, 2, 0, 15,49, 2, 10000
38, 2, 0, 16,56, 2, 10000
33, 2, 0, 8,43, 2, 10000
44, 2, 0, 9,55, 2, 10000
43, 2, 0, 10,55, 2, 10000
42, 2, 0, 16,60, 2, 10000
27, 2, 0, 6,35, 2, 10000
44, 2, 0, 8,54, 2, 10000
33, 2, 0, 7,42, 2, 10000
40, 2, 0, 14,56, 2, 10000
38, 2, 0, 17,57, 2, 10000
27, 2, 0, 12,41, 2, 10000
43, 2, 0, 11,56, 2, 10000
44, 2, 0, 16,62, 2, 10000
26, 2, 0, 12,40, 2, 10000
33, 2, 0, 6,41, 2, 10000
38, 2, 0, 9,49, 2, 10000
34, 2, 0, 13,49, 2, 10000
42, 2, 0, 19,63, 2, 10000
32, 2, 0, 12,46, 2, 10000
45, 2, 0, 12,59, 2, 10000
42, 2, 0, 12,56, 2, 10000
45, 2, 0, 11,58, 2, 10000
33, 2, 0, 12,47, 2, 10000
33, 2, 0, 10,45, 2, 10000
35, 2, 0, 15,52, 2, 10000
39, 2, 0, 11,52, 2, 10000
26, 2, 0, 6,34, 2, 10000
37, 2, 0, 16,55, 2, 10000
46, 2, 0, 4,52, 2, 10000
37, 2, 0, 10,49, 2, 10000
38, 2, 0, 12,52, 2, 10000
41, 2, 0, 17,60, 2, 10000
44, 2, 0, 11,57, 2, 10000
41, 2, 0, 9,52, 2, 10000
47, 2, 0, 22,71, 2, 10000
44, 2, 0, 14,60, 2, 10000
31, 2, 0, 11,44, 2, 10000
52, 2, 0, 11,65, 2, 10000
48, 2, 0, 9,59, 2, 10000
32, 2, 0, 9,43, 2, 10000
48, 2, 0, 10,60, 2, 10000
38, 2, 0, 10,50, 2, 10000
41, 2, 0, 11,54, 2, 10000
44, 2, 0, 8,54, 2, 10000
43, 2, 0, 13,58, 2, 10000
36, 2, 0, 8,46, 2, 10000
54, 2, 0, 11,67, 2, 10000
46, 2, 0, 17,65, 2, 10000
19, 2, 0, 7,28, 2, 10000
46, 2, 0, 13,61, 2, 10000
36, 2, 0, 9,47, 2, 10000
33, 2, 0, 13,48, 2, 10000
35, 2, 0, 7,44, 2, 10000
30, 2, 0, 16,48, 2, 10000
34, 2, 0, 11,47, 2, 10000
32, 2, 0, 13,47, 2, 10000
24, 2, 0, 14,40, 2, 10000
31, 2, 0, 12,45, 2, 10000
43, 2, 0, 17,62, 2, 10000
46, 2, 0, 7,55, 2, 10000
39, 2, 0, 17,58, 2, 10000
46, 2, 0, 8,56, 2, 10000
41, 2, 0, 13,56, 2, 10000
43, 2, 0, 11,56, 2, 10000
41, 2, 0, 8,51, 2, 10000
44, 2, 0, 11,57, 2, 10000
47, 2, 0, 10,59, 2, 10000
37, 2, 0, 9,48, 2, 10000
33, 2, 0, 9,44, 2, 10000
41, 2, 0, 12,55, 2, 10000
32, 2, 0, 11,45, 2, 10000
38, 2, 0, 6,46, 2, 10000
46, 2, 0, 9,57, 2, 10000
37, 2, 0, 6,45, 2, 10000
37, 2, 0, 12,51, 2, 10000
44, 2, 0, 4,50, 2, 10000
34, 2, 0, 8,44, 2, 10000
36, 2, 0, 11,49, 2, 10000
43, 2, 0, 9,54, 2, 10000
29, 2, 0, 14,45, 2, 10000
36, 2, 0, 14,52, 2, 10000
33, 2, 0, 15,50, 2, 10000
30, 2, 0, 16,48, 2, 10000
42, 2, 0, 11,55, 2, 10000
32, 2, 0, 12,46, 2, 10000
39, 2, 0, 6,47, 2, 10000
47, 2, 0, 15,64, 2, 10000
31, 2, 0, 5,38, 2, 10000
32, 2, 0, 11,45, 2, 10000
39, 2, 0, 9,50, 2, 10000
33, 2, 0, 16,51, 2, 10000
30, 2, 0, 9,41, 2, 10000
47, 2, 0, 19,68, 2, 10000
34, 2, 0, 9,45, 2, 10000
26, 2, 0, 11,39, 2, 10000
38, 2, 0, 15,55, 2, 10000
32, 2, 0, 11,45, 2, 10000
38, 2, 0, 12,52, 2, 10000
38, 2, 0, 15,55, 2, 10000
32, 2, 0, 11,45, 2, 10000
41, 2, 0, 7,50, 2, 10000
37, 2, 0, 10,49, 2, 10000
37, 2, 0, 5,44, 2, 10000
53, 2, 0, 9,64, 2, 10000
32, 2, 0, 11,45, 2, 10000
39, 2, 0, 11,52, 2, 10000
34, 2, 0, 5,41, 2, 10000
47, 2, 0, 14,63, 2, 10000
43, 2, 0, 6,51, 2, 10000
36, 2, 0, 15,53, 2, 10000
35, 2, 0, 17,54, 2, 10000
33, 2, 0, 11,46, 2, 10000
42, 2, 0, 17,61, 2, 10000
35, 2, 0, 10,47, 2, 10000
29, 2, 0, 10,41, 2, 10000
38, 2, 0, 17,57, 2, 10000
41, 2, 0, 13,56, 2, 10000
40, 2, 0, 6,48, 2, 10000
30, 2, 0, 11,43, 2, 10000
36, 2, 0, 9,47, 2, 10000
40, 2, 0, 14,56, 2, 10000
45, 2, 0, 8,55, 2, 10000
42, 2, 0, 2,46, 2, 10000
36, 2, 0, 13,51, 2, 10000
44, 2, 0, 8,54, 2, 10000
33, 2, 0, 11,46, 2, 10000
43, 2, 0, 6,51, 2, 10000
38, 2, 0, 15,55, 2, 10000
42, 2, 0, 9,53, 2, 10000
34, 2, 0, 13,49, 2, 10000
40, 2, 0, 14,56, 2, 10000
33, 2, 0, 19,54, 2, 10000
40, 2, 0, 13,55, 2, 10000
37, 2, 0, 10,49, 2, 10000
35, 2, 0, 10,47, 2, 10000
34, 2, 0, 14,50, 2, 10000
31, 2, 0, 12,45, 2, 10000
31, 2, 0, 9,42, 2, 10000
51, 2, 0, 11,64, 2, 10000
24, 2, 0, 7,33, 2, 10000
33, 2, 0, 7,42, 2, 10000
36, 2, 0, 11,49, 2, 10000
38, 2, 0, 8,48, 2, 10000
29, 2, 0, 14,45, 2, 10000
36, 2, 0, 16,54, 2, 10000
26, 2, 0, 12,40, 2, 10000
42, 2, 0, 14,58, 2, 10000
40, 2, 0, 10,52, 2, 10000
33, 2, 0, 14,49, 2, 10000
33, 2, 0, 10,45, 2, 10000
33, 2, 0, 13,48, 2, 10000
38, 2, 0, 15,55, 2, 10000
32, 2, 0, 9,43, 2, 10000
39, 2, 0, 11,52, 2, 10000
38, 2, 0, 15,55, 2, 10000
43, 2, 0, 13,58, 2, 10000
30, 2, 0, 8,40, 2, 10000
28, 2, 0, 13,43, 2, 10000
37, 2, 0, 9,48, 2, 10000
37, 2, 0, 17,56, 2, 10000
35, 2, 0, 12,49, 2, 10000
41, 2, 0, 8,51, 2, 10000
27, 2, 0, 12,41, 2, 10000
32, 2, 0, 15,49, 2, 10000
41, 2, 0, 9,52, 2, 10000
45, 2, 0, 13,60, 2, 10000
32, 2, 0, 12,46, 2, 10000
37, 2, 0, 13,52, 2, 10000
34, 2, 0, 14,50, 2, 10000
38, 2, 0, 10,50, 2, 10000
39, 2, 0, 11,52, 2, 10000
49, 2, 0, 14,65, 2, 10000
50, 2, 0, 13,65, 2, 10000
32, 2, 0, 14,48, 2, 10000
46, 2, 0, 15,63, 2, 10000
30, 2, 0, 9,41, 2, 10000
24, 2, 0, 9,35, 2, 10000
35, 2, 0, 7,44, 2, 10000
42, 2, 0, 10,54, 2, 10000
32, 2, 0, 7,41, 2, 10000
32, 2, 0, 9,43, 2, 10000
48, 2, 0, 10,60, 2, 10000
23, 2, 0, 12,37, 2, 10000
35, 2, 0, 10,47, 2, 10000
33, 2, 0, 8,43, 2, 10000
36, 2, 0, 12,50, 2, 10000
39, 2, 0, 7,48, 2, 10000
39, 2, 0, 11,52, 2, 10000
31, 2, 0, 7,40, 2, 10000
44, 2, 0, 10,56, 2, 10000
28, 2, 0, 7,37, 2, 10000
32, 2, 0, 16,50, 2, 10000
31, 2, 0, 10,43, 2, 10000
36, 2, 0, 11,49, 2, 10000
34, 2, 0, 8,44, 2, 10000
27, 2, 0, 11,40, 2, 10000
27, 2, 0, 9,38, 2, 10000
39, 2, 0, 10,51, 2, 10000
21, 2, 0, 10,33, 2, 10000
40, 2, 0, 10,52, 2, 10000
27, 2, 0, 11,40, 2, 10000
29, 2, 0, 13,44, 2, 10000
30, 2, 0, 14,46, 2, 10000
34, 2, 0, 10,46, 2, 10000
34, 2, 0, 6,42, 2, 10000
37, 2, 0, 10,49, 2, 10000
42, 2, 0, 10,54, 2, 10000
31, 2, 0, 9,42, 2, 10000
27, 2, 0, 8,37, 2, 10000
32, 2, 0, 10,44, 2, 10000
34, 2, 0, 11,47, 2, 10000
41, 2, 0, 13,56, 2, 10000
30, 2, 0, 9,41, 2, 10000
36, 2, 0, 11,49, 2, 10000
50, 2, 0, 8,60, 2, 10000
30, 2, 0, 13,45, 2, 10000
36, 2, 0, 15,53, 2, 10000
29, 2, 0, 11,42, 2, 10000
41, 2, 0, 6,49, 2, 10000
29, 2, 0, 7,38, 2, 10000
30, 2, 0, 10,42, 2, 10000
35, 2, 0, 8,45, 2, 10000
30, 2, 0, 14,46, 2, 10000
29, 2, 0, 6,37, 2, 10000
41, 2, 0, 7,50, 2, 10000
39, 2, 0, 11,52, 2, 10000
30, 2, 0, 7,39, 2, 10000
29, 2, 0, 7,38, 2, 10000
39, 2, 0, 13,54, 2, 10000
42, 2, 0, 13,57, 2, 10000
44, 2, 0, 6,52, 2, 10000
37, 2, 0, 11,50, 2, 10000
22, 2, 0, 10,34, 2, 10000
39, 2, 0, 12,53, 2, 10000
30, 2, 0, 8,40, 2, 10000
37, 2, 0, 8,47, 2, 10000
47, 2, 0, 10,59, 2, 10000
31, 2, 0, 13,46, 2, 10000
38, 2, 0, 9,49, 2, 10000
34, 2, 0, 10,46, 2, 10000
47, 2, 0, 8,57, 2, 10000
26, 2, 0, 9,37, 2, 10000
26, 2, 0, 14,42, 2, 10000
36, 2, 0, 8,46, 2, 10000
20, 2, 0, 15,37, 2, 10000
41, 2, 0, 11,54, 2, 10000
38, 2, 0, 6,46, 2, 10000
31, 2, 0, 9,42, 2, 10000
42, 2, 0, 9,53, 2, 10000
36, 2, 0, 14,52, 2, 10000
32, 2, 0, 6,40, 2, 10000
39, 2, 0, 10,51, 2, 10000
36, 2, 0, 11,49, 2, 10000
34, 2, 0, 12,48, 2, 10000
36, 2, 0, 12,50, 2, 10000
31, 2, 0, 8,41, 2, 10000
38, 2, 0, 7,47, 2, 10000
41, 2, 0, 8,51, 2, 10000
37, 2, 0, 8,47, 2, 10000
29, 2, 0, 11,42, 2, 10000
42, 2, 0, 4,48, 2, 10000
24, 2, 0, 7,33, 2, 10000
38, 2, 0, 4,44, 2, 10000
32, 2, 0, 7,41, 2, 10000
48, 2, 0, 8,58, 2, 10000
33, 2, 0, 6,41, 2, 10000
41, 2, 0, 13,56, 2, 10000
34, 2, 0, 6,42, 2, 10000
18, 2, 0, 10,30, 2, 10000
40, 2, 0, 9,51, 2, 10000
36, 2, 0, 9,47, 2, 10000
32, 2, 0, 10,44, 2, 10000
42, 2, 0, 11,55, 2, 10000
34, 2, 0, 13,49, 2, 10000
36, 2, 0, 6,44, 2, 10000
33, 2, 0, 13,48, 2, 10000
47, 2, 0, 8,57, 2, 10000
47, 2, 0, 16,65, 2, 10000
39, 2, 0, 6,47, 2, 10000
33, 2, 0, 9,44, 2, 10000
36, 2, 0, 10,48, 2, 10000
27, 2, 0, 9,38, 2, 10000
30, 2, 0, 20,52, 2, 10000
34, 2, 0, 12,48, 2, 10000
31, 2, 0, 12,45, 2, 10000
44, 2, 0, 10,56, 2, 10000
40, 2, 0, 6,48, 2, 10000
32, 2, 0, 14,48, 2, 10000
27, 2, 0, 18,47, 2, 10000
31, 2, 0, 13,46, 2, 10000
28, 2, 0, 8,38, 2, 10000
31, 2, 0, 17,50, 2, 10000
36, 2, 0, 13,51, 2, 10000
22, 2, 0, 11,35, 2, 10000
38, 2, 0, 6,46, 2, 10000
30, 2, 0, 16,48, 2, 10000
33, 2, 0, 16,51, 2, 10000
42, 2, 0, 10,54, 2, 10000
27, 2, 0, 7,36, 2, 10000
30, 2, 0, 8,40, 2, 10000
41, 2, 0, 10,53, 2, 10000
42, 2, 0, 9,53, 2, 10000
36, 2, 0, 12,50, 2, 10000
27, 2, 0, 11,40, 2, 10000
23, 2, 0, 13,38, 2, 10000
24, 2, 0, 11,37, 2, 10000
37, 2, 0, 8,47, 2, 10000
45, 2, 0, 9,56, 2, 10000
26, 2, 0, 8,36, 2, 10000
27, 2, 0, 5,34, 2, 10000
44, 2, 0, 17,63, 2, 10000
28, 2, 0, 15,45, 2, 10000
26, 2, 0, 11,39, 2, 10000
28, 2, 0, 10,40, 2, 10000
35, 2, 0, 9,46, 2, 10000
39, 2, 0, 6,47, 2, 10000
34, 2, 0, 10,46, 2, 10000
36, 2, 0, 13,51, 2, 10000
29, 2, 0, 11,42, 2, 10000
36, 2, 0, 12,50, 2, 10000
31, 2, 0, 11,44, 2, 10000
40, 2, 0, 19,61, 2, 10000
32, 2, 0, 4,38, 2, 10000
31, 2, 0, 18,51, 2, 10000
29, 2, 0, 12,43, 2, 10000
42, 2, 0, 11,55, 2, 10000
26, 2, 0, 7,35, 2, 10000
36, 2, 0, 11,49, 2, 10000
45, 2, 0, 7,54, 2, 10000
30, 2, 0, 9,41, 2, 10000
22, 2, 0, 7,31, 2, 10000
32, 2, 0, 9,43, 2, 10000
36, 2, 0, 16,54, 2, 10000
24, 2, 0, 12,38, 2, 10000
45, 2, 0, 6,53, 2, 10000
29, 2, 0, 6,37, 2, 10000
30, 2, 0, 17,49, 2, 10000
36, 2, 0, 4,42, 2, 10000
33, 2, 0, 10,45, 2, 10000
33, 2, 0, 12,47, 2, 10000
32, 2, 0, 8,42, 2, 10000
33, 2, 0, 8,43, 2, 10000
28, 2, 0, 7,37, 2, 10000
41, 2, 0, 11,54, 2, 10000
33, 2, 0, 14,49, 2, 10000
28, 2, 0, 8,38, 2, 10000
37, 2, 0, 10,49, 2, 10000
42, 2, 0, 8,52, 2, 10000
33, 2, 0, 10,45, 2, 10000
33, 2, 0, 15,50, 2, 10000
32, 2, 0, 13,47, 2, 10000
35, 2, 0, 6,43, 2, 10000
30, 2, 0, 9,41, 2, 10000
30, 2, 0, 10,42, 2, 10000
31, 2, 0, 9,42, 2, 10000
31, 2, 0, 5,38, 2, 10000
27, 2, 0, 9,38, 2, 10000
35, 2, 0, 7,44, 2, 10000
33, 2, 0, 6,41, 2, 10000
42, 2, 0, 12,56, 2, 10000
32, 2, 0, 9,43, 2, 10000
40, 2, 0, 7,49, 2, 10000
24, 2, 0, 11,37, 2, 10000
23, 2, 0, 7,32, 2, 10000
28, 2, 0, 10,40, 2, 10000
33, 2, 0, 6,41, 2, 10000
41, 2, 0, 8,51, 2, 10000
30, 2, 0, 9,41, 2, 10000
28, 2, 0, 7,37, 2, 10000
37, 2, 0, 9,48, 2, 10000
42, 2, 0, 8,52, 2, 10000
37, 2, 0, 9,48, 2, 10000
37, 2, 0, 14,53, 2, 10000
17, 2, 0, 9,28, 2, 10000
39, 2, 0, 14,55, 2, 10000
39, 2, 0, 12,53, 2, 10000
36, 2, 0, 9,47, 2, 10000
23, 2, 0, 12,37, 2, 10000
40, 2, 0, 7,49, 2, 10000
33, 2, 0, 7,42, 2, 10000
24, 2, 0, 7,33, 2, 10000
24, 2, 0, 7,33, 2, 10000
35, 2, 0, 12,49, 2, 10000
31, 2, 0, 17,50, 2, 10000
29, 2, 0, 11,42, 2, 10000
30, 2, 0, 12,44, 2, 10000
32, 2, 0, 13,47, 2, 10000
21, 2, 0, 8,31, 2, 10000
36, 2, 0, 10,48, 2, 10000
39, 2, 0, 12,53, 2, 10000
27, 2, 0, 8,37, 2, 10000
37, 2, 0, 6,45, 2, 10000
33, 2, 0, 12,47, 2, 10000
27, 2, 0, 9,38, 2, 10000
32, 2, 0, 12,46, 2, 10000
24, 2, 0, 9,35, 2, 10000
36, 2, 0, 8,46, 2, 10000
45, 2, 0, 10,57, 2, 10000
23, 2, 0, 8,33, 2, 10000
31, 2, 0, 6,39, 2, 10000
36, 2, 0, 7,45, 2, 10000
29, 2, 0, 12,43, 2, 10000
37, 2, 0, 10,49, 2, 10000
38, 2, 0, 7,47, 2, 10000
37, 2, 0, 6,45, 2, 10000
29, 2, 0, 6,37, 2, 10000
33, 2, 0, 6,41, 2, 10000
24, 2, 0, 13,39, 2, 10000
30, 2, 0, 13,45, 2, 10000
30, 2, 0, 5,37, 2, 10000
23, 2, 0, 10,35, 2, 10000
33, 2, 0, 10,45, 2, 10000
42, 2, 0, 6,50, 2, 10000
38, 2, 0, 11,51, 2, 10000
29, 2, 0, 8,39, 2, 10000
30, 2, 0, 7,39, 2, 10000
31, 2, 0, 15,48, 2, 10000
33, 2, 0, 4,39, 2, 10000
32, 2, 0, 10,44, 2, 10000
42, 2, 0, 9,53, 2, 10000
33, 2, 0, 4,39, 2, 10000
25, 2, 0, 10,37, 2, 10000
38, 2, 0, 15,55, 2, 10000
28, 2, 0, 10,40, 2, 10000
37, 2, 0, 7,46, 2, 10000
27, 2, 0, 7,36, 2, 10000
31, 2, 0, 9,42, 2, 10000
33, 2, 0, 9,44, 2, 10000
35, 2, 0, 13,50, 2, 10000
19, 2, 0, 7,28, 2, 10000
34, 2, 0, 6,42, 2, 10000
35, 2, 0, 14,51, 2, 10000
29, 2, 0, 10,41, 2, 10000
32, 2, 0, 6,40, 2, 10000
36, 2, 0, 9,47, 2, 10000
23, 2, 0, 11,36, 2, 10000
33, 2, 0, 9,44, 2, 10000
35, 2, 0, 7,44, 2, 10000
26, 2, 0, 4,32, 2, 10000
32, 2, 0, 8,42, 2, 10000
21, 2, 0, 16,39, 2, 10000
43, 2, 0, 9,54, 2, 10000
26, 2, 0, 6,34, 2, 10000
31, 2, 0, 13,46, 2, 10000
27, 2, 0, 12,41, 2, 10000
21, 2, 0, 8,31, 2, 10000
28, 2, 0, 8,38, 2, 10000
23, 2, 0, 6,31, 2, 10000
37, 2, 0, 8,47, 2, 10000
28, 2, 0, 11,41, 2, 10000
38, 2, 0, 8,48, 2, 10000
31, 2, 0, 6,39, 2, 10000
37, 2, 0, 10,49, 2, 10000
36, 2, 0, 8,46, 2, 10000
36, 2, 0, 14,52, 2, 10000
34, 2, 0, 10,46, 2, 10000
36, 2, 0, 9,47, 2, 10000
40, 2, 0, 3,45, 2, 10000
26, 2, 0, 4,32, 2, 10000
36, 2, 0, 5,43, 2, 10000
36, 2, 0, 9,47, 2, 10000
32, 2, 0, 8,42, 2, 10000
21, 2, 0, 10,33, 2, 10000
30, 2, 0, 11,43, 2, 10000
33, 2, 0, 12,47, 2, 10000
29, 2, 0, 4,35, 2, 10000
25, 2, 0, 12,39, 2, 10000
31, 2, 0, 8,41, 2, 10000
31, 2, 0, 15,48, 2, 10000
34, 2, 0, 11,47, 2, 10000
25, 2, 0, 11,38, 2, 10000
36, 2, 0, 10,48, 2, 10000
26, 2, 0, 12,40, 2, 10000
30, 2, 0, 8,40, 2, 10000
36, 2, 0, 8,46, 2, 10000
31, 2, 0, 14,47, 2, 10000
38, 2, 0, 12,52, 2, 10000
38, 2, 0, 15,55, 2, 10000
39, 2, 0, 13,54, 2, 10000
27, 2, 0, 8,37, 2, 10000
25, 2, 0, 8,35, 2, 10000
35, 2, 0, 12,49, 2, 10000
30, 2, 0, 6,38, 2, 10000
30, 2, 0, 11,43, 2, 10000
31, 2, 0, 7,40, 2, 10000
28, 2, 0, 10,40, 2, 10000
31, 2, 0, 14,47, 2, 10000
24, 2, 0, 4,30, 2, 10000
28, 2, 0, 8,38, 2, 10000
34, 2, 0, 7,43, 2, 10000
31, 2, 0, 10,43, 2, 10000
32, 2, 0, 10,44, 2, 10000
34, 2, 0, 9,45, 2, 10000
41, 2, 0, 14,57, 2, 10000
32, 2, 0, 8,42, 2, 10000
35, 2, 0, 8,45, 2, 10000
36, 2, 0, 15,53, 2, 10000
35, 2, 0, 6,43, 2, 10000
27, 2, 0, 7,36, 2, 10000
30, 2, 0, 8,40, 2, 10000
31, 2, 0, 6,39, 2, 10000
22, 2, 0, 9,33, 2, 10000
34, 2, 0, 11,47, 2, 10000
22, 2, 0, 8,32, 2, 10000
34, 2, 0, 8,44, 2, 10000
37, 2, 0, 10,49, 2, 10000
33, 2, 0, 11,46, 2, 10000
30, 2, 0, 6,38, 2, 10000
21, 2, 0, 14,37, 2, 10000
28, 2, 0, 6,36, 2, 10000
29, 2, 0, 11,42, 2, 10000
28, 2, 0, 6,36, 2, 10000
30, 2, 0, 8,40, 2, 10000
30, 2, 0, 8,40, 2, 10000
33, 2, 0, 5,40, 2, 10000
26, 2, 0, 9,37, 2, 10000
27, 2, 0, 9,38, 2, 10000
29, 2, 0, 6,37, 2, 10000
30, 2, 0, 10,42, 2, 10000
19, 2, 0, 9,30, 2, 10000
30, 2, 0, 11,43, 2, 10000
30, 2, 0, 10,42, 2, 10000
48, 2, 0, 7,57, 2, 10000
36, 2, 0, 5,43, 2, 10000
28, 2, 0, 12,42, 2, 10000
31, 2, 0, 9,42, 2, 10000
34, 2, 0, 6,42, 2, 10000
21, 2, 0, 6,29, 2, 10000
36, 2, 0, 10,48, 2, 10000
32, 2, 0, 10,44, 2, 10000
31, 2, 0, 11,44, 2, 10000
21, 2, 0, 9,32, 2, 10000
30, 2, 0, 13,45, 2, 10000
37, 2, 0, 12,51, 2, 10000
32, 2, 0, 4,38, 2, 10000
36, 2, 0, 3,41, 2, 10000
22, 2, 0, 8,32, 2, 10000
30, 2, 0, 6,38, 2, 10000
32, 2, 0, 9,43, 2, 10000
17, 2, 0, 8,27, 2, 10000
28, 2, 0, 10,40, 2, 10000
28, 2, 0, 8,38, 2, 10000
27, 2, 0, 6,35, 2, 10000
31, 2, 0, 6,39, 2, 10000
30, 2, 0, 12,44, 2, 10000
30, 2, 0, 9,41, 2, 10000
27, 2, 0, 8,37, 2, 10000
38, 2, 0, 9,49, 2, 10000
21, 2, 0, 5,28, 2, 10000
26, 2, 0, 14,42, 2, 10000
32, 2, 0, 7,41, 2, 10000
22, 2, 0, 8,32, 2, 10000
24, 2, 0, 7,33, 2, 10000
27, 2, 0, 12,41, 2, 10000
28, 2, 0, 12,42, 2, 10000
32, 2, 0, 9,43, 2, 10000
46, 2, 0, 6,54, 2, 10000
31, 2, 0, 8,41, 2, 10000
31, 2, 0, 5,38, 2, 10000
26, 2, 0, 6,34, 2, 10000
35, 2, 0, 11,48, 2, 10000
29, 2, 0, 11,42, 2, 10000
23, 2, 0, 12,37, 2, 10000
26, 2, 0, 8,36, 2, 10000
36, 2, 0, 7,45, 2, 10000
33, 2, 0, 13,48, 2, 10000
26, 2, 0, 11,39, 2, 10000
36, 2, 0, 13,51, 2, 10000
24, 2, 0, 9,35, 2, 10000
30, 2, 0, 10,42, 2, 10000
39, 2, 0, 5,46, 2, 10000
24, 2, 0, 6,32, 2, 10000
42, 2, 0, 6,50, 2, 10000
32, 2, 0, 4,38, 2, 10000
22, 2, 0, 6,30, 2, 10000
31, 2, 0, 6,39, 2, 10000
31, 2, 0, 5,38, 2, 10000
35, 2, 0, 7,44, 2, 10000
29, 2, 0, 11,42, 2, 10000
32, 2, 0, 10,44, 2, 10000
22, 2, 0, 8,32, 2, 10000
27, 2, 0, 11,40, 2, 10000
31, 2, 0, 7,40, 2, 10000
36, 2, 0, 6,44, 2, 10000
31, 2, 0, 9,42, 2, 10000
23, 2, 0, 11,36, 2, 10000
36, 2, 0, 7,45, 2, 10000
27, 2, 0, 11,40, 2, 10000
29, 2, 0, 7,38, 2, 10000
35, 2, 0, 7,44, 2, 10000
30, 2, 0, 7,39, 2, 10000
38, 2, 0, 10,50, 2, 10000
38, 2, 0, 12,52, 2, 10000
27, 2, 0, 11,40, 2, 10000
44, 2, 0, 10,56, 2, 10000
27, 2, 0, 9,38, 2, 10000
27, 2, 0, 7,36, 2, 10000
29, 2, 0, 11,42, 2, 10000
31, 2, 0, 6,39, 2, 10000
26, 2, 0, 5,33, 2, 10000
22, 2, 0, 10,34, 2, 10000
22, 2, 0, 10,34, 2, 10000
39, 2, 0, 7,48, 2, 10000
26, 2, 0, 10,38, 2, 10000
30, 2, 0, 12,44, 2, 10000
27, 2, 0, 10,39, 2, 10000
37, 2, 0, 7,46, 2, 10000
32, 2, 0, 6,40, 2, 10000
34, 2, 0, 7,43, 2, 10000
28, 2, 0, 5,35, 2, 10000
24, 2, 0, 10,36, 2, 10000
29, 2, 0, 12,43, 2, 10000
35, 2, 0, 8,45, 2, 10000
27, 2, 0, 13,42, 2, 10000
38, 2, 0, 3,43, 2, 10000
22, 2, 0, 10,34, 2, 10000
26, 2, 0, 10,38, 2, 10000
28, 2, 0, 9,39, 2, 10000
41, 2, 0, 8,51, 2, 10000
27, 2, 0, 12,41, 2, 10000
26, 2, 0, 13,41, 2, 10000
37, 2, 0, 10,49, 2, 10000
30, 2, 0, 9,41, 2, 10000
27, 2, 0, 7,36, 2, 10000
27, 2, 0, 10,39, 2, 10000
28, 2, 0, 4,34, 2, 10000
41, 2, 0, 10,53, 2, 10000
42, 2, 0, 14,58, 2, 10000
23, 2, 0, 8,33, 2, 10000
28, 2, 0, 10,40, 2, 10000
35, 2, 0, 9,46, 2, 10000
25, 2, 0, 14,41, 2, 10000
25, 2, 0, 8,35, 2, 10000
22, 2, 0, 3,27, 2, 10000
33, 2, 0, 12,47, 2, 10000
22, 2, 0, 12,36, 2, 10000
21, 2, 0, 12,35, 2, 10000
30, 2, 0, 12,44, 2, 10000
27, 2, 0, 10,39, 2, 10000
30, 2, 0, 4,36, 2, 10000
31, 2, 0, 7,40, 2, 10000
27, 2, 0, 10,39, 2, 10000
24, 2, 0, 7,33, 2, 10000
29, 2, 0, 2,33, 2, 10000
28, 2, 0, 7,37, 2, 10000
32, 2, 0, 9,43, 2, 10000
32, 2, 0, 7,41, 2, 10000
19, 2, 0, 4,25, 2, 10000
33, 2, 0, 9,44, 2, 10000
33, 2, 0, 12,47, 2, 10000
27, 2, 0, 8,37, 2, 10000
14, 2, 0, 6,22, 2, 10000
28, 2, 0, 11,41, 2, 10000
27, 2, 0, 6,35, 2, 10000
41, 2, 0, 3,46, 2, 10000
26, 2, 0, 13,41, 2, 10000
34, 2, 0, 8,44, 2, 10000
35, 2, 0, 14,51, 2, 10000
21, 2, 0, 3,26, 2, 10000
17, 2, 0, 7,26, 2, 10000
27, 2, 0, 9,38, 2, 10000
28, 2, 0, 10,40, 2, 10000
28, 2, 0, 11,41, 2, 10000
19, 2, 0, 12,33, 2, 10000
33, 2, 0, 9,44, 2, 10000
32, 2, 0, 10,44, 2, 10000
27, 2, 0, 11,40, 2, 10000
25, 2, 0, 6,33, 2, 10000
32, 2, 0, 11,45, 2, 10000
23, 2, 0, 5,30, 2, 10000
27, 2, 0, 10,39, 2, 10000
32, 2, 0, 6,40, 2, 10000
24, 2, 0, 8,34, 2, 10000
27, 2, 0, 5,34, 2, 10000
25, 2, 0, 7,34, 2, 10000
20, 2, 0, 9,31, 2, 10000
35, 2, 0, 5,42, 2, 10000
23, 2, 0, 5,30, 2, 10000
29, 2, 0, 9,40, 2, 10000
23, 2, 0, 4,29, 2, 10000
26, 2, 0, 9,37, 2, 10000
38, 2, 0, 8,48, 2, 10000
35, 2, 0, 6,43, 2, 10000
28, 2, 0, 10,40, 2, 10000
31, 2, 0, 14,47, 2, 10000
20, 2, 0, 9,31, 2, 10000
33, 2, 0, 5,40, 2, 10000
34, 2, 0, 9,45, 2, 10000
26, 2, 0, 7,35, 2, 10000
26, 2, 0, 6,34, 2, 10000
18, 2, 0, 8,28, 2, 10000
30, 2, 0, 12,44, 2, 10000
24, 2, 0, 10,36, 2, 10000
37, 2, 0, 10,49, 2, 10000
26, 2, 0, 9,37, 2, 10000
24, 2, 0, 12,38, 2, 10000
36, 2, 0, 9,47, 2, 10000
38, 2, 0, 9,49, 2, 10000
21, 2, 0, 13,36, 2, 10000
36, 2, 0, 12,50, 2, 10000
26, 2, 0, 7,35, 2, 10000
32, 2, 0, 11,45, 2, 10000
37, 2, 0, 10,49, 2, 10000
27, 2, 0, 8,37, 2, 10000
32, 2, 0, 11,45, 2, 10000
32, 2, 0, 9,43, 2, 10000
35, 2, 0, 3,40, 2, 10000
31, 2, 0, 6,39, 2, 10000
25, 2, 0, 7,34, 2, 10000
30, 2, 0, 9,41, 2, 10000
32, 2, 0, 8,42, 2, 10000
40, 2, 0, 10,52, 2, 10000
38, 2, 0, 10,50, 2, 10000
33, 2, 0, 8,43, 2, 10000
30, 2, 0, 12,44, 2, 10000
24, 2, 0, 8,34, 2, 10000
27, 2, 0, 5,34, 2, 10000
30, 2, 0, 3,35, 2, 10000
24, 2, 0, 6,32, 2, 10000
20, 2, 0, 8,30, 2, 10000
27, 2, 0, 6,35, 2, 10000
30, 2, 0, 11,43, 2, 10000
34, 2, 0, 9,45, 2, 10000
27, 2, 0, 9,38, 2, 10000
31, 2, 0, 6,39, 2, 10000
28, 2, 0, 6,36, 2, 10000
20, 2, 0, 9,31, 2, 10000
30, 2, 0, 11,43, 2, 10000
37, 2, 0, 12,51, 2, 10000
25, 2, 0, 9,36, 2, 10000
24, 2, 0, 10,36, 2, 10000
29, 2, 0, 10,41, 2, 10000
18, 2, 0, 3,23, 2, 10000
28, 2, 0, 13,43, 2, 10000
25, 2, 0, 11,38, 2, 10000
22, 2, 0, 12,36, 2, 10000
24, 2, 0, 5,31, 2, 10000
31, 2, 0, 11,44, 2, 10000
28, 2, 0, 9,39, 2, 10000
28, 2, 0, 13,43, 2, 10000
25, 2, 0, 11,38, 2, 10000
31, 2, 0, 8,41, 2, 10000
33, 2, 0, 15,50, 2, 10000
30, 2, 0, 7,39, 2, 10000
23, 2, 0, 7,32, 2, 10000
32, 2, 0, 3,37, 2, 10000
22, 2, 0, 10,34, 2, 10000
18, 2, 0, 9,29, 2, 10000
33, 2, 0, 8,43, 2, 10000
26, 2, 0, 8,36, 2, 10000
26, 2, 0, 7,35, 2, 10000
29, 2, 0, 11,42, 2, 10000
20, 2, 0, 7,29, 2, 10000
20, 2, 0, 10,32, 2, 10000
20, 2, 0, 7,29, 2, 10000
28, 2, 0, 9,39, 2, 10000
28, 2, 0, 3,33, 2, 10000
35, 2, 0, 6,43, 2, 10000
33, 2, 0, 15,50, 2, 10000
28, 2, 0, 7,37, 2, 10000
26, 2, 0, 11,39, 2, 10000
33, 2, 0, 11,46, 2, 10000
26, 2, 0, 7,35, 2, 10000
25, 2, 0, 9,36, 2, 10000
32, 2, 0, 8,42, 2, 10000
35, 2, 0, 7,44, 2, 10000
37, 2, 0, 7,46, 2, 10000
22, 2, 0, 5,29, 2, 10000
42, 2, 0, 6,50, 2, 10000
30, 2, 0, 9,41, 2, 10000
28, 2, 0, 5,35, 2, 10000
34, 2, 0, 10,46, 2, 10000
30, 2, 0, 7,39, 2, 10000
22, 2, 0, 5,29, 2, 10000
29, 2, 0, 6,37, 2, 10000
22, 2, 0, 9,33, 2, 10000
28, 2, 0, 12,42, 2, 10000
22, 2, 0, 8,32, 2, 10000
38, 2, 0, 12,52, 2, 10000
32, 2, 0, 8,42, 2, 10000
29, 2, 0, 6,37, 2, 10000
36, 2, 0, 7,45, 2, 10000
24, 2, 0, 23,49, 2, 10000
30, 2, 0, 10,42, 2, 10000
35, 2, 0, 9,46, 2, 10000
28, 2, 0, 8,38, 2, 10000
30, 2, 0, 9,41, 2, 10000
20, 2, 0, 5,27, 2, 10000
21, 2, 0, 9,32, 2, 10000
23, 2, 0, 11,36, 2, 10000
23, 2, 0, 10,35, 2, 10000
25, 2, 0, 7,34, 2, 10000
24, 2, 0, 5,31, 2, 10000
36, 2, 0, 6,44, 2, 10000
21, 2, 0, 10,33, 2, 10000
36, 2, 0, 7,45, 2, 10000
27, 2, 0, 8,37, 2, 10000
28, 2, 0, 3,33, 2, 10000
29, 2, 0, 9,40, 2, 10000
24, 2, 0, 11,37, 2, 10000
23, 2, 0, 8,33, 2, 10000
29, 2, 0, 14,45, 2, 10000
28, 2, 0, 9,39, 2, 10000
36, 2, 0, 9,47, 2, 10000
19, 2, 0, 13,34, 2, 10000
25, 2, 0, 8,35, 2, 10000
23, 2, 0, 4,29, 2, 10000
33, 2, 0, 7,42, 2, 10000
27, 2, 0, 10,39, 2, 10000
22, 2, 0, 6,30, 2, 10000
18, 2, 0, 10,30, 2, 10000
35, 2, 0, 10,47, 2, 10000
36, 2, 0, 11,49, 2, 10000
24, 2, 0, 9,35, 2, 10000
24, 2, 0, 14,40, 2, 10000
23, 2, 0, 6,31, 2, 10000
26, 2, 0, 6,34, 2, 10000
28, 2, 0, 7,37, 2, 10000
27, 2, 0, 12,41, 2, 10000
25, 2, 0, 5,32, 2, 10000
22, 2, 0, 10,34, 2, 10000
26, 2, 0, 13,41, 2, 10000
20, 2, 0, 10,32, 2, 10000
31, 2, 0, 7,40, 2, 10000
26, 2, 0, 6,34, 2, 10000
31, 2, 0, 2,35, 2, 10000
27, 2, 0, 10,39, 2, 10000
34, 2, 0, 15,51, 2, 10000
27, 2, 0, 10,39, 2, 10000
31, 2, 0, 10,43, 2, 10000
29, 2, 0, 6,37, 2, 10000
22, 2, 0, 5,29, 2, 10000
37, 2, 0, 10,49, 2, 10000
22, 2, 0, 6,30, 2, 10000
31, 2, 0, 6,39, 2, 10000
25, 2, 0, 9,36, 2, 10000
22, 2, 0, 12,36, 2, 10000
27, 2, 0, 10,39, 2, 10000
20, 2, 0, 5,27, 2, 10000
36, 2, 0, 7,45, 2, 10000
26, 2, 0, 14,42, 2, 10000
23, 2, 0, 4,29, 2, 10000
23, 2, 0, 4,29, 2, 10000
23, 2, 0, 17,42, 2, 10000
26, 2, 0, 14,42, 2, 10000
19, 2, 0, 8,29, 2, 10000
26, 2, 0, 7,35, 2, 10000
26, 2, 0, 12,40, 2, 10000
26, 2, 0, 5,33, 2, 10000
33, 2, 0, 5,40, 2, 10000
26, 2, 0, 7,35, 2, 10000
25, 2, 0, 6,33, 2, 10000
29, 2, 0, 11,42, 2, 10000
27, 2, 0, 11,40, 2, 10000
27, 2, 0, 6,35, 2, 10000
28, 2, 0, 8,38, 2, 10000
28, 2, 0, 15,45, 2, 10000
35, 2, 0, 1,38, 2, 10000
22, 2, 0, 7,31, 2, 10000
23, 2, 0, 4,29, 2, 10000
6, 2, 0, 8,16, 2, 10000
20, 2, 0, 8,30, 2, 10000
23, 2, 0, 7,32, 2, 10000
18, 2, 0, 10,30, 2, 10000
20, 2, 0, 7,29, 2, 10000
30, 2, 0, 10,42, 2, 10000
32, 2, 0, 7,41, 2, 10000
32, 2, 0, 7,41, 2, 10000
26, 2, 0, 7,35, 2, 10000
28, 2, 0, 8,38, 2, 10000
26, 2, 0, 7,35, 2, 10000
20, 2, 0, 8,30, 2, 10000
29, 2, 0, 6,37, 2, 10000
37, 2, 0, 8,47, 2, 10000
37, 2, 0, 9,48, 2, 10000
35, 2, 0, 10,47, 2, 10000
21, 2, 0, 10,33, 2, 10000
35, 2, 0, 10,47, 2, 10000
30, 2, 0, 8,40, 2, 10000
28, 2, 0, 12,42, 2, 10000
28, 2, 0, 8,38, 2, 10000
27, 2, 0, 6,35, 2, 10000
33, 2, 0, 8,43, 2, 10000
22, 2, 0, 4,28, 2, 10000
33, 2, 0, 9,44, 2, 10000
22, 2, 0, 9,33, 2, 10000
23, 2, 0, 4,29, 2, 10000
21, 2, 0, 9,32, 2, 10000
31, 2, 0, 10,43, 2, 10000
29, 2, 0, 3,34, 2, 10000
28, 2, 0, 5,35, 2, 10000
26, 2, 0, 10,38, 2, 10000
24, 2, 0, 18,44, 2, 10000
14, 2, 0, 8,24, 2, 10000
22, 2, 0, 6,30, 2, 10000
28, 2, 0, 10,40, 2, 10000
19, 2, 0, 6,27, 2, 10000
27, 2, 0, 10,39, 2, 10000
37, 2, 0, 5,44, 2, 10000
29, 2, 0, 10,41, 2, 10000
16, 2, 0, 8,26, 2, 10000
24, 2, 0, 7,33, 2, 10000
26, 2, 0, 8,36, 2, 10000
29, 2, 0, 14,45, 2, 10000
24, 2, 0, 11,37, 2, 10000
29, 2, 0, 5,36, 2, 10000
23, 2, 0, 8,33, 2, 10000
21, 2, 0, 9,32, 2, 10000
26, 2, 0, 9,37, 2, 10000
20, 2, 0, 4,26, 2, 10000
35, 2, 0, 9,46, 2, 10000
31, 2, 0, 9,42, 2, 10000
29, 2, 0, 6,37, 2, 10000
26, 2, 0, 8,36, 2, 10000
29, 2, 0, 5,36, 2, 10000
21, 2, 0, 5,28, 2, 10000
22, 2, 0, 2,26, 2, 10000
30, 2, 0, 7,39, 2, 10000
29, 2, 0, 4,35, 2, 10000
24, 2, 0, 8,34, 2, 10000
26, 2, 0, 7,35, 2, 10000
24, 2, 0, 7,33, 2, 10000
30, 2, 0, 4,36, 2, 10000
27, 2, 0, 8,37, 2, 10000
27, 2, 0, 5,34, 2, 10000
25, 2, 0, 9,36, 2, 10000
26, 2, 0, 6,34, 2, 10000
23, 2, 0, 8,33, 2, 10000
20, 2, 0, 7,29, 2, 10000
22, 2, 0, 8,32, 2, 10000
27, 2, 0, 13,42, 2, 10000
31, 2, 0, 7,40, 2, 10000
30, 2, 0, 9,41, 2, 10000
25, 2, 0, 7,34, 2, 10000
23, 2, 0, 8,33, 2, 10000
25, 2, 0, 4,31, 2, 10000
27, 2, 0, 3,32, 2, 10000
26, 2, 0, 7,35, 2, 10000
28, 2, 0, 10,40, 2, 10000
21, 2, 0, 3,26, 2, 10000
33, 2, 0, 9,44, 2, 10000
41, 2, 0, 8,51, 2, 10000
27, 2, 0, 10,39, 2, 10000
25, 2, 0, 6,33, 2, 10000
25, 2, 0, 11,38, 2, 10000
31, 2, 0, 4,37, 2, 10000
33, 2, 0, 6,41, 2, 10000
23, 2, 0, 11,36, 2, 10000
25, 2, 0, 6,33, 2, 10000
31, 2, 0, 9,42, 2, 10000
26, 2, 0, 6,34, 2, 10000
21, 2, 0, 13,36, 2, 10000
30, 2, 0, 13,45, 2, 10000
28, 2, 0, 6,36, 2, 10000
13, 2, 0, 9,24, 2, 10000
27, 2, 0, 3,32, 2, 10000
22, 2, 0, 8,32, 2, 10000
27, 2, 0, 3,32, 2, 10000
20, 2, 0, 11,33, 2, 10000
23, 2, 0, 6,31, 2, 10000
21, 2, 0, 9,32, 2, 10000
19, 2, 0, 6,27, 2, 10000
24, 2, 0, 10,36, 2, 10000
24, 2, 0, 7,33, 2, 10000
32, 2, 0, 10,44, 2, 10000
17, 2, 0, 5,24, 2, 10000
17, 2, 0, 10,29, 2, 10000
36, 2, 0, 9,47, 2, 10000
22, 2, 0, 9,33, 2, 10000
24, 2, 0, 16,42, 2, 10000
21, 2, 0, 4,27, 2, 10000
25, 2, 0, 9,36, 2, 10000
29, 2, 0, 10,41, 2, 10000
24, 2, 0, 3,29, 2, 10000
26, 2, 0, 7,35, 2, 10000
23, 2, 0, 10,35, 2, 10000
28, 2, 0, 13,43, 2, 10000
20, 2, 0, 8,30, 2, 10000
18, 2, 0, 6,26, 2, 10000
25, 2, 0, 4,31, 2, 10000
23, 2, 0, 6,31, 2, 10000
28, 2, 0, 8,38, 2, 10000
23, 2, 0, 10,35, 2, 10000
29, 2, 0, 4,35, 2, 10000
32, 2, 0, 5,39, 2, 10000
17, 2, 0, 4,23, 2, 10000
26, 2, 0, 7,35, 2, 10000
30, 2, 0, 12,44, 2, 10000
23, 2, 0, 7,32, 2, 10000
24, 2, 0, 9,35, 2, 10000
24, 2, 0, 6,32, 2, 10000
24, 2, 0, 7,33, 2, 10000
22, 2, 0, 13,37, 2, 10000
23, 2, 0, 10,35, 2, 10000
26, 2, 0, 3,31, 2, 10000
20, 2, 0, 8,30, 2, 10000
31, 2, 0, 4,37, 2, 10000
22, 2, 0, 11,35, 2, 10000
21, 2, 0, 4,27, 2, 10000
33, 2, 0, 8,43, 2, 10000
29, 2, 0, 3,34, 2, 10000
28, 2, 0, 5,35, 2, 10000
22, 2, 0, 6,30, 2, 10000
24, 2, 0, 10,36, 2, 10000
32, 2, 0, 11,45, 2, 10000
24, 2, 0, 8,34, 2, 10000
25, 2, 0, 11,38, 2, 10000
33, 2, 0, 3,38, 2, 10000
14, 2, 0, 7,23, 2, 10000
27, 2, 0, 9,38, 2, 10000
24, 2, 0, 10,36, 2, 10000
28, 2, 0, 6,36, 2, 10000
27, 2, 0, 6,35, 2, 10000
27, 2, 0, 10,39, 2, 10000
22, 2, 0, 5,29, 2, 10000
30, 2, 0, 6,38, 2, 10000
15, 2, 0, 10,27, 2, 10000
26, 2, 0, 7,35, 2, 10000
23, 2, 0, 8,33, 2, 10000
31, 2, 0, 8,41, 2, 10000
22, 2, 0, 7,31, 2, 10000
26, 2, 0, 6,34, 2, 10000
26, 2, 0, 6,34, 2, 10000
26, 2, 0, 14,42, 2, 10000
18, 2, 0, 3,23, 2, 10000
31, 2, 0, 4,37, 2, 10000
35, 2, 0, 11,48, 2, 10000
30, 2, 0, 13,45, 2, 10000
29, 2, 0, 6,37, 2, 10000
13, 2, 0, 13,28, 2, 10000
22, 2, 0, 4,28, 2, 10000
20, 2, 0, 6,28, 2, 10000
31, 2, 0, 5,38, 2, 10000
26, 2, 0, 8,36, 2, 10000
25, 2, 0, 6,33, 2, 10000
32, 2, 0, 10,44, 2, 10000
32, 2, 0, 7,41, 2, 10000
25, 2, 0, 6,33, 2, 10000
10, 2, 0, 6,18, 2, 10000
17, 2, 0, 6,25, 2, 10000
22, 2, 0, 11,35, 2, 10000
26, 2, 0, 10,38, 2, 10000
29, 2, 0, 5,36, 2, 10000
28, 2, 0, 5,35, 2, 10000
21, 2, 0, 4,27, 2, 10000
22, 2, 0, 7,31, 2, 10000
39, 2, 0, 7,48, 2, 10000
18, 2, 0, 10,30, 2, 10000
29, 2, 0, 6,37, 2, 10000
17, 2, 0, 6,25, 2, 10000
23, 2, 0, 5,30, 2, 10000
19, 2, 0, 8,29, 2, 10000
21, 2, 0, 4,27, 2, 10000
29, 2, 0, 5,36, 2, 10000
23, 2, 0, 6,31, 2, 10000
25, 2, 0, 9,36, 2, 10000
37, 2, 0, 14,53, 2, 10000
31, 2, 0, 11,44, 2, 10000
25, 2, 0, 9,36, 2, 10000
17, 2, 0, 7,26, 2, 10000
29, 2, 0, 5,36, 2, 10000
19, 2, 0, 5,26, 2, 10000
22, 2, 0, 3,27, 2, 10000
24, 2, 0, 7,33, 2, 10000
15, 2, 0, 12,29, 2, 10000
27, 2, 0, 5,34, 2, 10000
27, 2, 0, 9,38, 2, 10000
16, 2, 0, 4,22, 2, 10000
26, 2, 0, 11,39, 2, 10000
23, 2, 0, 12,37, 2, 10000
20, 2, 0, 5,27, 2, 10000
28, 2, 0, 5,35, 2, 10000
26, 2, 0, 10,38, 2, 10000
26, 2, 0, 7,35, 2, 10000
22, 2, 0, 4,28, 2, 10000
23, 2, 0, 6,31, 2, 10000
23, 2, 0, 9,34, 2, 10000
22, 2, 0, 7,31, 2, 10000
24, 2, 0, 6,32, 2, 10000
36, 2, 0, 10,48, 2, 10000
16, 2, 0, 4,22, 2, 10000
30, 2, 0, 7,39, 2, 10000
18, 2, 0, 11,31, 2, 10000
15, 2, 0, 9,26, 2, 10000
29, 2, 0, 7,38, 2, 10000
29, 2, 0, 11,42, 2, 10000
23, 2, 0, 5,30, 2, 10000
26, 2, 0, 5,33, 2, 10000
24, 2, 0, 2,28, 2, 10000
25, 2, 0, 10,37, 2, 10000
16, 2, 0, 7,25, 2, 10000
16, 2, 0, 6,24, 2, 10000
20, 2, 0, 7,29, 2, 10000
29, 2, 0, 6,37, 2, 10000
22, 2, 0, 7,31, 2, 10000
30, 2, 0, 7,39, 2, 10000
23, 2, 0, 11,36, 2, 10000
20, 2, 0, 13,35, 2, 10000
22, 2, 0, 6,30, 2, 10000
28, 2, 0, 6,36, 2, 10000
20, 2, 0, 3,25, 2, 10000
19, 2, 0, 9,30, 2, 10000
26, 2, 0, 9,37, 2, 10000
39, 2, 0, 7,48, 2, 10000
30, 2, 0, 5,37, 2, 10000
22, 2, 0, 5,29, 2, 10000
37, 2, 0, 7,46, 2, 10000
20, 2, 0, 6,28, 2, 10000
22, 2, 0, 12,36, 2, 10000
29, 2, 0, 8,39, 2, 10000
21, 2, 0, 9,32, 2, 10000
27, 2, 0, 10,39, 2, 10000
16, 2, 0, 7,25, 2, 10000
16, 2, 0, 4,22, 2, 10000
18, 2, 0, 7,27, 2, 10000
20, 2, 0, 7,29, 2, 10000
22, 2, 0, 9,33, 2, 10000
24, 2, 0, 5,31, 2, 10000
19, 2, 0, 15,36, 2, 10000
22, 2, 0, 6,30, 2, 10000
24, 2, 0, 5,31, 2, 10000
30, 2, 0, 3,35, 2, 10000
10, 2, 0, 9,21, 2, 10000
30, 2, 0, 3,35, 2, 10000
21, 2, 0, 5,28, 2, 10000
37, 2, 0, 4,43, 2, 10000
16, 2, 0, 10,28, 2, 10000
24, 2, 0, 7,33, 2, 10000
26, 2, 0, 7,35, 2, 10000
21, 2, 0, 2,25, 2, 10000
24, 2, 0, 7,33, 2, 10000
25, 2, 0, 8,35, 2, 10000
38, 2, 0, 2,42, 2, 10000
17, 2, 0, 12,31, 2, 10000
24, 2, 0, 6,32, 2, 10000
23, 2, 0, 7,32, 2, 10000
19, 2, 0, 7,28, 2, 10000
31, 2, 0, 9,42, 2, 10000
24, 2, 0, 3,29, 2, 10000
30, 2, 0, 7,39, 2, 10000
30, 2, 0, 5,37, 2, 10000
23, 2, 0, 8,33, 2, 10000
32, 2, 0, 3,37, 2, 10000
17, 2, 0, 4,23, 2, 10000
29, 2, 0, 5,36, 2, 10000
26, 2, 0, 7,35, 2, 10000
21, 2, 0, 4,27, 2, 10000
19, 2, 0, 5,26, 2, 10000
17, 2, 0, 8,27, 2, 10000
22, 2, 0, 8,32, 2, 10000
23, 2, 0, 8,33, 2, 10000
20, 2, 0, 6,28, 2, 10000
22, 2, 0, 6,30, 2, 10000
12, 2, 0, 8,22, 2, 10000
28, 2, 0, 4,34, 2, 10000
29, 2, 0, 5,36, 2, 10000
21, 2, 0, 5,28, 2, 10000
25, 2, 0, 10,37, 2, 10000
37, 2, 0, 7,46, 2, 10000
28, 2, 0, 4,34, 2, 10000
19, 2, 0, 6,27, 2, 10000
25, 2, 0, 4,31, 2, 10000
27, 2, 0, 9,38, 2, 10000
23, 2, 0, 11,36, 2, 10000
23, 2, 0, 11,36, 2, 10000
20, 2, 0, 6,28, 2, 10000
18, 2, 0, 7,27, 2, 10000
21, 2, 0, 10,33, 2, 10000
30, 2, 0, 10,42, 2, 10000
16, 2, 0, 7,25, 2, 10000
25, 2, 0, 10,37, 2, 10000
25, 2, 0, 13,40, 2, 10000
32, 2, 0, 8,42, 2, 10000
25, 2, 0, 5,32, 2, 10000
27, 2, 0, 10,39, 2, 10000
27, 2, 0, 5,34, 2, 10000
24, 2, 0, 6,32, 2, 10000
17, 2, 0, 7,26, 2, 10000
25, 2, 0, 6,33, 2, 10000
23, 2, 0, 7,32, 2, 10000
26, 2, 0, 12,40, 2, 10000
26, 2, 0, 5,33, 2, 10000
19, 2, 0, 7,28, 2, 10000
22, 2, 0, 7,31, 2, 10000
23, 2, 0, 8,33, 2, 10000
19, 2, 0, 9,30, 2, 10000
30, 2, 0, 12,44, 2, 10000
28, 2, 0, 6,36, 2, 10000
26, 2, 0, 7,35, 2, 10000
23, 2, 0, 11,36, 2, 10000
25, 2, 0, 7,34, 2, 10000
16, 2, 0, 8,26, 2, 10000
23, 2, 0, 4,29, 2, 10000
19, 2, 0, 6,27, 2, 10000
29, 2, 0, 8,39, 2, 10000
22, 2, 0, 10,34, 2, 10000
27, 2, 0, 6,35, 2, 10000
28, 2, 0, 8,38, 2, 10000
31, 2, 0, 5,38, 2, 10000
17, 2, 0, 4,23, 2, 10000
24, 2, 0, 12,38, 2, 10000
23, 2, 0, 7,32, 2, 10000
23, 2, 0, 10,35, 2, 10000
24, 2, 0, 8,34, 2, 10000
24, 2, 0, 2,28, 2, 10000
30, 2, 0, 10,42, 2, 10000
23, 2, 0, 6,31, 2, 10000
19, 2, 0, 5,26, 2, 10000
22, 2, 0, 11,35, 2, 10000
23, 2, 0, 6,31, 2, 10000
16, 2, 0, 6,24, 2, 10000
17, 2, 0, 14,33, 2, 10000
22, 2, 0, 5,29, 2, 10000
25, 2, 0, 5,32, 2, 10000
27, 2, 0, 13,42, 2, 10000
19, 2, 0, 3,24, 2, 10000
21, 2, 0, 8,31, 2, 10000
18, 2, 0, 9,29, 2, 10000
18, 2, 0, 7,27, 2, 10000
40, 2, 0, 4,46, 2, 10000
20, 2, 0, 3,25, 2, 10000
24, 2, 0, 9,35, 2, 10000
16, 2, 0, 6,24, 2, 10000
19, 2, 0, 5,26, 2, 10000
30, 2, 0, 8,40, 2, 10000
19, 2, 0, 9,30, 2, 10000
28, 2, 0, 10,40, 2, 10000
32, 2, 0, 9,43, 2, 10000
20, 2, 0, 8,30, 2, 10000
24, 2, 0, 5,31, 2, 10000
17, 2, 0, 6,25, 2, 10000
24, 2, 0, 4,30, 2, 10000
22, 2, 0, 5,29, 2, 10000
16, 2, 0, 5,23, 2, 10000
18, 2, 0, 3,23, 2, 10000
21, 2, 0, 9,32, 2, 10000
31, 2, 0, 7,40, 2, 10000
25, 2, 0, 10,37, 2, 10000
12, 2, 0, 9,23, 2, 10000
23, 2, 0, 11,36, 2, 10000
26, 2, 0, 12,40, 2, 10000
24, 2, 0, 5,31, 2, 10000
21, 2, 0, 11,34, 2, 10000
19, 2, 0, 8,29, 2, 10000
16, 2, 0, 10,28, 2, 10000
20, 2, 0, 10,32, 2, 10000
28, 2, 0, 10,40, 2, 10000
25, 2, 0, 5,32, 2, 10000
17, 2, 0, 7,26, 2, 10000
31, 2, 0, 8,41, 2, 10000
33, 2, 0, 11,46, 2, 10000
20, 2, 0, 5,27, 2, 10000
27, 2, 0, 8,37, 2, 10000
16, 2, 0, 4,22, 2, 10000
21, 2, 0, 9,32, 2, 10000
13, 2, 0, 7,22, 2, 10000
20, 2, 0, 4,26, 2, 10000
23, 2, 0, 6,31, 2, 10000
23, 2, 0, 8,33, 2, 10000
26, 2, 0, 7,35, 2, 10000
21, 2, 0, 8,31, 2, 10000
23, 2, 0, 3,28, 2, 10000
31, 2, 0, 11,44, 2, 10000
19, 2, 0, 6,27, 2, 10000
23, 2, 0, 7,32, 2, 10000
23, 2, 0, 6,31, 2, 10000
24, 2, 0, 7,33, 2, 10000
26, 2, 0, 8,36, 2, 10000
24, 2, 0, 12,38, 2, 10000
14, 2, 0, 13,29, 2, 10000
22, 2, 0, 10,34, 2, 10000
26, 2, 0, 7,35, 2, 10000
23, 2, 0, 7,32, 2, 10000
16, 2, 0, 5,23, 2, 10000
30, 2, 0, 1,33, 2, 10000
22, 2, 0, 0,24, 2, 10000
21, 2, 0, 8,31, 2, 10000
27, 2, 0, 10,39, 2, 10000
13, 2, 0, 6,21, 2, 10000
38, 2, 0, 7,47, 2, 10000
17, 2, 0, 8,27, 2, 10000
18, 2, 0, 7,27, 2, 10000
25, 2, 0, 9,36, 2, 10000
20, 2, 0, 4,26, 2, 10000
15, 2, 0, 2,19, 2, 10000
26, 2, 0, 7,35, 2, 10000
24, 2, 0, 9,35, 2, 10000
26, 2, 0, 6,34, 2, 10000
22, 2, 0, 9,33, 2, 10000
17, 2, 0, 8,27, 2, 10000
31, 2, 0, 8,41, 2, 10000
22, 2, 0, 8,32, 2, 10000
20, 2, 0, 5,27, 2, 10000
17, 2, 0, 9,28, 2, 10000
25, 2, 0, 5,32, 2, 10000
20, 2, 0, 7,29, 2, 10000
21, 2, 0, 6,29, 2, 10000
20, 2, 0, 5,27, 2, 10000
23, 2, 0, 3,28, 2, 10000
17, 2, 0, 7,26, 2, 10000
19, 2, 0, 8,29, 2, 10000
18, 2, 0, 9,29, 2, 10000
16, 2, 0, 5,23, 2, 10000
21, 2, 0, 8,31, 2, 10000
23, 2, 0, 5,30, 2, 10000
26, 2, 0, 8,36, 2, 10000
21, 2, 0, 5,28, 2, 10000
28, 2, 0, 8,38, 2, 10000
27, 2, 0, 8,37, 2, 10000
17, 2, 0, 9,28, 2, 10000
27, 2, 0, 8,37, 2, 10000
28, 2, 0, 8,38, 2, 10000
21, 2, 0, 3,26, 2, 10000
24, 2, 0, 3,29, 2, 10000
20, 2, 0, 6,28, 2, 10000
28, 2, 0, 7,37, 2, 10000
23, 2, 0, 5,30, 2, 10000
30, 2, 0, 4,36, 2, 10000
17, 2, 0, 11,30, 2, 10000
23, 2, 0, 5,30, 2, 10000
25, 2, 0, 1,28, 2, 10000
18, 2, 0, 8,28, 2, 10000
17, 2, 0, 7,26, 2, 10000
20, 2, 0, 5,27, 2, 10000
16, 2, 0, 10,28, 2, 10000
28, 2, 0, 8,38, 2, 10000
23, 2, 0, 4,29, 2, 10000
22, 2, 0, 4,28, 2, 10000
18, 2, 0, 10,30, 2, 10000
21, 2, 0, 8,31, 2, 10000
17, 2, 0, 8,27, 2, 10000
19, 2, 0, 13,34, 2, 10000
22, 2, 0, 6,30, 2, 10000
19, 2, 0, 4,25, 2, 10000
17, 2, 0, 4,23, 2, 10000
28, 2, 0, 6,36, 2, 10000
33, 2, 0, 4,39, 2, 10000
23, 2, 0, 7,32, 2, 10000
30, 2, 0, 6,38, 2, 10000
20, 2, 0, 8,30, 2, 10000
25, 2, 0, 4,31, 2, 10000
23, 2, 0, 6,31, 2, 10000
15, 2, 0, 6,23, 2, 10000
29, 2, 0, 3,34, 2, 10000
20, 2, 0, 6,28, 2, 10000
19, 2, 0, 7,28, 2, 10000
19, 2, 0, 7,28, 2, 10000
21, 2, 0, 4,27, 2, 10000
19, 2, 0, 6,27, 2, 10000
18, 2, 0, 6,26, 2, 10000
24, 2, 0, 4,30, 2, 10000
18, 2, 0, 9,29, 2, 10000
16, 2, 0, 9,27, 2, 10000
18, 2, 0, 8,28, 2, 10000
23, 2, 0, 8,33, 2, 10000
17, 2, 0, 9,28, 2, 10000
21, 2, 0, 7,30, 2, 10000
21, 2, 0, 5,28, 2, 10000
22, 2, 0, 10,34, 2, 10000
29, 2, 0, 9,40, 2, 10000
30, 2, 0, 9,41, 2, 10000
19, 2, 0, 8,29, 2, 10000
22, 2, 0, 7,31, 2, 10000
22, 2, 0, 6,30, 2, 10000
25, 2, 0, 7,34, 2, 10000
22, 2, 0, 5,29, 2, 10000
23, 2, 0, 4,29, 2, 10000
20, 2, 0, 10,32, 2, 10000
13, 2, 0, 9,24, 2, 10000
22, 2, 0, 3,27, 2, 10000
13, 2, 0, 8,23, 2, 10000
27, 2, 0, 5,34, 2, 10000
26, 2, 0, 9,37, 2, 10000
23, 2, 0, 8,33, 2, 10000
30, 2, 0, 10,42, 2, 10000
19, 2, 0, 9,30, 2, 10000
20, 2, 0, 2,24, 2, 10000
26, 2, 0, 7,35, 2, 10000
22, 2, 0, 10,34, 2, 10000
21, 2, 0, 10,33, 2, 10000
16, 2, 0, 7,25, 2, 10000
15, 2, 0, 13,30, 2, 10000
17, 2, 0, 7,26, 2, 10000
24, 2, 0, 5,31, 2, 10000
20, 2, 0, 8,30, 2, 10000
26, 2, 0, 9,37, 2, 10000
18, 2, 0, 6,26, 2, 10000
27, 2, 0, 7,36, 2, 10000
18, 2, 0, 5,25, 2, 10000
19, 2, 0, 4,25, 2, 10000
22, 2, 0, 9,33, 2, 10000
13, 2, 0, 5,20, 2, 10000
17, 2, 0, 7,26, 2, 10000
35, 2, 0, 7,44, 2, 10000
13, 2, 0, 14,29, 2, 10000
26, 2, 0, 6,34, 2, 10000
24, 2, 0, 4,30, 2, 10000
15, 2, 0, 11,28, 2, 10000
33, 2, 0, 7,42, 2, 10000
16, 2, 0, 6,24, 2, 10000
29, 2, 0, 2,33, 2, 10000
19, 2, 0, 9,30, 2, 10000
22, 2, 0, 6,30, 2, 10000
18, 2, 0, 7,27, 2, 10000
27, 2, 0, 4,33, 2, 10000
28, 2, 0, 9,39, 2, 10000
18, 2, 0, 5,25, 2, 10000
13, 2, 0, 5,20, 2, 10000
30, 2, 0, 9,41, 2, 10000
21, 2, 0, 7,30, 2, 10000
32, 2, 0, 5,39, 2, 10000
29, 2, 0, 1,32, 2, 10000
20, 2, 0, 9,31, 2, 10000
23, 2, 0, 7,32, 2, 10000
21, 2, 0, 7,30, 2, 10000
24, 2, 0, 12,38, 2, 10000
14, 2, 0, 6,22, 2, 10000
16, 2, 0, 5,23, 2, 10000
15, 2, 0, 10,27, 2, 10000
17, 2, 0, 12,31, 2, 10000
30, 2, 0, 3,35, 2, 10000
16, 2, 0, 10,28, 2, 10000
17, 2, 0, 5,24, 2, 10000
32, 2, 0, 4,38, 2, 10000
19, 2, 0, 5,26, 2, 10000
20, 2, 0, 8,30, 2, 10000
21, 2, 0, 5,28, 2, 10000
20, 2, 0, 5,27, 2, 10000
19, 2, 0, 9,30, 2, 10000
22, 2, 0, 9,33, 2, 10000
23, 2, 0, 11,36, 2, 10000
21, 2, 0, 3,26, 2, 10000
11, 2, 0, 4,17, 2, 10000
26, 2, 0, 7,35, 2, 10000
23, 2, 0, 8,33, 2, 10000
20, 2, 0, 6,28, 2, 10000
27, 2, 0, 6,35, 2, 10000
25, 2, 0, 3,30, 2, 10000
20, 2, 0, 2,24, 2, 10000
17, 2, 0, 6,25, 2, 10000
17, 2, 0, 5,24, 2, 10000
16, 2, 0, 6,24, 2, 10000
23, 2, 0, 4,29, 2, 10000
33, 2, 0, 4,39, 2, 10000
18, 2, 0, 4,24, 2, 10000
21, 2, 0, 2,25, 2, 10000
26, 2, 0, 4,32, 2, 10000
27, 2, 0, 5,34, 2, 10000
11, 2, 0, 9,22, 2, 10000
30, 2, 0, 4,36, 2, 10000
22, 2, 0, 4,28, 2, 10000
33, 2, 0, 4,39, 2, 10000
24, 2, 0, 7,33, 2, 10000
19, 2, 0, 6,27, 2, 10000
25, 2, 0, 7,34, 2, 10000
25, 2, 0, 5,32, 2, 10000
17, 2, 0, 7,26, 2, 10000
21, 2, 0, 5,28, 2, 10000
22, 2, 0, 9,33, 2, 10000
20, 2, 0, 6,28, 2, 10000
27, 2, 0, 4,33, 2, 10000
24, 2, 0, 4,30, 2, 10000
25, 2, 0, 3,30, 2, 10000
24, 2, 0, 10,36, 2, 10000
19, 2, 0, 3,24, 2, 10000
13, 2, 0, 11,26, 2, 10000
14, 2, 0, 5,21, 2, 10000
16, 2, 0, 6,24, 2, 10000
17, 2, 0, 6,25, 2, 10000
26, 2, 0, 5,33, 2, 10000
24, 2, 0, 5,31, 2, 10000
5, 2, 0, 11,18, 2, 10000
16, 2, 0, 6,24, 2, 10000
23, 2, 0, 5,30, 2, 10000
31, 2, 0, 6,39, 2, 10000
19, 2, 0, 8,29, 2, 10000
28, 2, 0, 10,40, 2, 10000
19, 2, 0, 6,27, 2, 10000
22, 2, 0, 7,31, 2, 10000
21, 2, 0, 6,29, 2, 10000
29, 2, 0, 14,45, 2, 10000
21, 2, 0, 4,27, 2, 10000
17, 2, 0, 4,23, 2, 10000
18, 2, 0, 10,30, 2, 10000
15, 2, 0, 5,22, 2, 10000
31, 2, 0, 8,41, 2, 10000
27, 2, 0, 3,32, 2, 10000
14, 2, 0, 3,19, 2, 10000
21, 2, 0, 6,29, 2, 10000
28, 2, 0, 12,42, 2, 10000
17, 2, 0, 5,24, 2, 10000
24, 2, 0, 9,35, 2, 10000
22, 2, 0, 8,32, 2, 10000
18, 2, 0, 4,24, 2, 10000
17, 2, 0, 9,28, 2, 10000
21, 2, 0, 8,31, 2, 10000
19, 2, 0, 11,32, 2, 10000
20, 2, 0, 7,29, 2, 10000
29, 2, 0, 6,37, 2, 10000
16, 2, 0, 8,26, 2, 10000
17, 2, 0, 8,27, 2, 10000
21, 2, 0, 8,31, 2, 10000
22, 2, 0, 12,36, 2, 10000
22, 2, 0, 5,29, 2, 10000
23, 2, 0, 3,28, 2, 10000
20, 2, 0, 10,32, 2, 10000
15, 2, 0, 4,21, 2, 10000
17, 2, 0, 6,25, 2, 10000
26, 2, 0, 6,34, 2, 10000
21, 2, 0, 10,33, 2, 10000
28, 2, 0, 5,35, 2, 10000
19, 2, 0, 5,26, 2, 10000
17, 2, 0, 9,28, 2, 10000
24, 2, 0, 9,35, 2, 10000
28, 2, 0, 3,33, 2, 10000
17, 2, 0, 5,24, 2, 10000
27, 2, 0, 7,36, 2, 10000
26, 2, 0, 6,34, 2, 10000
25, 2, 0, 5,32, 2, 10000
24, 2, 0, 2,28, 2, 10000
31, 2, 0, 8,41, 2, 10000
25, 2, 0, 8,35, 2, 10000
17, 2, 0, 4,23, 2, 10000
16, 2, 0, 13,31, 2, 10000
24, 2, 0, 3,29, 2, 10000
18, 2, 0, 9,29, 2, 10000
24, 2, 0, 6,32, 2, 10000
19, 2, 0, 2,23, 2, 10000
25, 2, 0, 5,32, 2, 10000
21, 2, 0, 9,32, 2, 10000
25, 2, 0, 6,33, 2, 10000
18, 2, 0, 7,27, 2, 10000
30, 2, 0, 6,38, 2, 10000
24, 2, 0, 9,35, 2, 10000
29, 2, 0, 5,36, 2, 10000
22, 2, 0, 4,28, 2, 10000
30, 2, 0, 5,37, 2, 10000
27, 2, 0, 11,40, 2, 10000
26, 2, 0, 5,33, 2, 10000
20, 2, 0, 6,28, 2, 10000
21, 2, 0, 7,30, 2, 10000
19, 2, 0, 6,27, 2, 10000
18, 2, 0, 5,25, 2, 10000
24, 2, 0, 5,31, 2, 10000
20, 2, 0, 3,25, 2, 10000
21, 2, 0, 6,29, 2, 10000
18, 2, 0, 7,27, 2, 10000
28, 2, 0, 9,39, 2, 10000
22, 2, 0, 7,31, 2, 10000
12, 2, 0, 8,22, 2, 10000
24, 2, 0, 7,33, 2, 10000
23, 2, 0, 11,36, 2, 10000
25, 2, 0, 7,34, 2, 10000
14, 2, 0, 7,23, 2, 10000
29, 2, 0, 5,36, 2, 10000
24, 2, 0, 7,33, 2, 10000
11, 2, 0, 4,17, 2, 10000
18, 2, 0, 2,22, 2, 10000
14, 2, 0, 5,21, 2, 10000
34, 2, 0, 11,47, 2, 10000
17, 2, 0, 8,27, 2, 10000
13, 2, 0, 7,22, 2, 10000
26, 2, 0, 5,33, 2, 10000
22, 2, 0, 6,30, 2, 10000
17, 2, 0, 5,24, 2, 10000
25, 2, 0, 9,36, 2, 10000
28, 2, 0, 8,38, 2, 10000
20, 2, 0, 8,30, 2, 10000
26, 2, 0, 4,32, 2, 10000
19, 2, 0, 6,27, 2, 10000
20, 2, 0, 9,31, 2, 10000
20, 2, 0, 6,28, 2, 10000
18, 2, 0, 8,28, 2, 10000
29, 2, 0, 0,31, 2, 10000
27, 2, 0, 4,33, 2, 10000
15, 2, 0, 3,20, 2, 10000
25, 2, 0, 2,29, 2, 10000
14, 2, 0, 6,22, 2, 10000
24, 2, 0, 6,32, 2, 10000
18, 2, 0, 6,26, 2, 10000
16, 2, 0, 6,24, 2, 10000
16, 2, 0, 3,21, 2, 10000
26, 2, 0, 8,36, 2, 10000
23, 2, 0, 9,34, 2, 10000
16, 2, 0, 2,20, 2, 10000
23, 2, 0, 8,33, 2, 10000
22, 2, 0, 4,28, 2, 10000
28, 2, 0, 9,39, 2, 10000
26, 2, 0, 6,34, 2, 10000
24, 2, 0, 5,31, 2, 10000
20, 2, 0, 5,27, 2, 10000
19, 2, 0, 3,24, 2, 10000
18, 2, 0, 9,29, 2, 10000
20, 2, 0, 7,29, 2, 10000
21, 2, 0, 5,28, 2, 10000
17, 2, 0, 9,28, 2, 10000
18, 2, 0, 5,25, 2, 10000
21, 2, 0, 5,28, 2, 10000
16, 2, 0, 7,25, 2, 10000
24, 2, 0, 9,35, 2, 10000
13, 2, 0, 6,21, 2, 10000
12, 2, 0, 2,16, 2, 10000
18, 2, 0, 9,29, 2, 10000
25, 2, 0, 8,35, 2, 10000
17, 2, 0, 5,24, 2, 10000
16, 2, 0, 9,27, 2, 10000
21, 2, 0, 12,35, 2, 10000
22, 2, 0, 11,35, 2, 10000
16, 2, 0, 6,24, 2, 10000
15, 2, 0, 5,22, 2, 10000
28, 2, 0, 10,40, 2, 10000
23, 2, 0, 8,33, 2, 10000
21, 2, 0, 6,29, 2, 10000
16, 2, 0, 10,28, 2, 10000
25, 2, 0, 8,35, 2, 10000
24, 2, 0, 6,32, 2, 10000
30, 2, 0, 7,39, 2, 10000
18, 2, 0, 4,24, 2, 10000
13, 2, 0, 8,23, 2, 10000
11, 2, 0, 5,18, 2, 10000
27, 2, 0, 4,33, 2, 10000
19, 2, 0, 5,26, 2, 10000
6, 2, 0, 7,15, 2, 10000
24, 2, 0, 1,27, 2, 10000
22, 2, 0, 7,31, 2, 10000
24, 2, 0, 9,35, 2, 10000
23, 2, 0, 3,28, 2, 10000
12, 2, 0, 9,23, 2, 10000
16, 2, 0, 7,25, 2, 10000
21, 2, 0, 7,30, 2, 10000
24, 2, 0, 5,31, 2, 10000
25, 2, 0, 9,36, 2, 10000
24, 2, 0, 8,34, 2, 10000
22, 2, 0, 7,31, 2, 10000
14, 2, 0, 11,27, 2, 10000
15, 2, 0, 5,22, 2, 10000
24, 2, 0, 4,30, 2, 10000
16, 2, 0, 8,26, 2, 10000
23, 2, 0, 7,32, 2, 10000
24, 2, 0, 7,33, 2, 10000
14, 2, 0, 7,23, 2, 10000
23, 2, 0, 8,33, 2, 10000
21, 2, 0, 5,28, 2, 10000
32, 2, 0, 6,40, 2, 10000
17, 2, 0, 4,23, 2, 10000
23, 2, 0, 8,33, 2, 10000
25, 2, 0, 7,34, 2, 10000
17, 2, 0, 3,22, 2, 10000
24, 2, 0, 5,31, 2, 10000
16, 2, 0, 5,23, 2, 10000
22, 2, 0, 8,32, 2, 10000
10, 2, 0, 4,16, 2, 10000
19, 2, 0, 8,29, 2, 10000
25, 2, 0, 7,34, 2, 10000
13, 2, 0, 3,18, 2, 10000
15, 2, 0, 5,22, 2, 10000
16, 2, 0, 7,25, 2, 10000
21, 2, 0, 7,30, 2, 10000
20, 2, 0, 9,31, 2, 10000
17, 2, 0, 9,28, 2, 10000
19, 2, 0, 6,27, 2, 10000
26, 2, 0, 6,34, 2, 10000
14, 2, 0, 5,21, 2, 10000
19, 2, 0, 6,27, 2, 10000
16, 2, 0, 1,19, 2, 10000
28, 2, 0, 9,39, 2, 10000
22, 2, 0, 5,29, 2, 10000
20, 2, 0, 11,33, 2, 10000
21, 2, 0, 3,26, 2, 10000
21, 2, 0, 4,27, 2, 10000
27, 2, 0, 4,33, 2, 10000
14, 2, 0, 6,22, 2, 10000
23, 2, 0, 2,27, 2, 10000
21, 2, 0, 8,31, 2, 10000
25, 2, 0, 13,40, 2, 10000
18, 2, 0, 6,26, 2, 10000
12, 2, 0, 3,17, 2, 10000
28, 2, 0, 5,35, 2, 10000
26, 2, 0, 6,34, 2, 10000
15, 2, 0, 5,22, 2, 10000
14, 2, 0, 4,20, 2, 10000
15, 2, 0, 10,27, 2, 10000
14, 2, 0, 4,20, 2, 10000
27, 2, 0, 7,36, 2, 10000
23, 2, 0, 6,31, 2, 10000
18, 2, 0, 8,28, 2, 10000
9, 2, 0, 3,14, 2, 10000
18, 2, 0, 6,26, 2, 10000
28, 2, 0, 7,37, 2, 10000
18, 2, 0, 8,28, 2, 10000
32, 2, 0, 9,43, 2, 10000
21, 2, 0, 8,31, 2, 10000
22, 2, 0, 8,32, 2, 10000
16, 2, 0, 6,24, 2, 10000
16, 2, 0, 3,21, 2, 10000
9, 2, 0, 5,16, 2, 10000
19, 2, 0, 12,33, 2, 10000
25, 2, 0, 5,32, 2, 10000
23, 2, 0, 11,36, 2, 10000
19, 2, 0, 4,25, 2, 10000
21, 2, 0, 7,30, 2, 10000
22, 2, 0, 6,30, 2, 10000
15, 2, 0, 9,26, 2, 10000
14, 2, 0, 5,21, 2, 10000
18, 2, 0, 4,24, 2, 10000
18, 2, 0, 6,26, 2, 10000
26, 2, 0, 11,39, 2, 10000
15, 2, 0, 6,23, 2, 10000
17, 2, 0, 4,23, 2, 10000
17, 2, 0, 6,25, 2, 10000
21, 2, 0, 7,30, 2, 10000
28, 2, 0, 4,34, 2, 10000
22, 2, 0, 11,35, 2, 10000
18, 2, 0, 1,21, 2, 10000
18, 2, 0, 8,28, 2, 10000
31, 2, 0, 8,41, 2, 10000
13, 2, 0, 5,20, 2, 10000
25, 2, 0, 2,29, 2, 10000
28, 2, 0, 5,35, 2, 10000
18, 2, 0, 10,30, 2, 10000
27, 2, 0, 8,37, 2, 10000
24, 2, 0, 4,30, 2, 10000
23, 2, 0, 3,28, 2, 10000
22, 2, 0, 4,28, 2, 10000
17, 2, 0, 5,24, 2, 10000
22, 2, 0, 5,29, 2, 10000
28, 2, 0, 7,37, 2, 10000
18, 2, 0, 6,26, 2, 10000
22, 2, 0, 5,29, 2, 10000
22, 2, 0, 9,33, 2, 10000
19, 2, 0, 5,26, 2, 10000
16, 2, 0, 5,23, 2, 10000
28, 2, 0, 7,37, 2, 10000
28, 2, 0, 3,33, 2, 10000
17, 2, 0, 10,29, 2, 10000
16, 2, 0, 2,20, 2, 10000
18, 2, 0, 6,26, 2, 10000
20, 2, 0, 8,30, 2, 10000
18, 2, 0, 7,27, 2, 10000
15, 2, 0, 8,25, 2, 10000
17, 2, 0, 6,25, 2, 10000
16, 2, 0, 3,21, 2, 10000
20, 2, 0, 8,30, 2, 10000
15, 2, 0, 4,21, 2, 10000
18, 2, 0, 5,25, 2, 10000
17, 2, 0, 5,24, 2, 10000
22, 2, 0, 5,29, 2, 10000
25, 2, 0, 8,35, 2, 10000
22, 2, 0, 5,29, 2, 10000
14, 2, 0, 7,23, 2, 10000
21, 2, 0, 4,27, 2, 10000
19, 2, 0, 7,28, 2, 10000
17, 2, 0, 5,24, 2, 10000
28, 2, 0, 4,34, 2, 10000
26, 2, 0, 7,35, 2, 10000
26, 2, 0, 6,34, 2, 10000
13, 2, 0, 4,19, 2, 10000
19, 2, 0, 6,27, 2, 10000
9, 2, 0, 5,16, 2, 10000
13, 2, 0, 6,21, 2, 10000
23, 2, 0, 7,32, 2, 10000
13, 2, 0, 17,32, 2, 10000
12, 2, 0, 6,20, 2, 10000
20, 2, 0, 6,28, 2, 10000
23, 2, 0, 4,29, 2, 10000
16, 2, 0, 0,18, 2, 10000
23, 2, 0, 6,31, 2, 10000
30, 2, 0, 6,38, 2, 10000
18, 2, 0, 9,29, 2, 10000
14, 2, 0, 9,25, 2, 10000
26, 2, 0, 10,38, 2, 10000
22, 2, 0, 7,31, 2, 10000
29, 2, 0, 5,36, 2, 10000
17, 2, 0, 6,25, 2, 10000
13, 2, 0, 6,21, 2, 10000
13, 2, 0, 3,18, 2, 10000
20, 2, 0, 5,27, 2, 10000
21, 2, 0, 10,33, 2, 10000
15, 2, 0, 8,25, 2, 10000
15, 2, 0, 12,29, 2, 10000
26, 2, 0, 4,32, 2, 10000
22, 2, 0, 6,30, 2, 10000
27, 2, 0, 8,37, 2, 10000
25, 2, 0, 5,32, 2, 10000
15, 2, 0, 7,24, 2, 10000
21, 2, 0, 3,26, 2, 10000
25, 2, 0, 6,33, 2, 10000
23, 2, 0, 3,28, 2, 10000
18, 2, 0, 6,26, 2, 10000
24, 2, 0, 5,31, 2, 10000
22, 2, 0, 7,31, 2, 10000
17, 2, 0, 8,27, 2, 10000
24, 2, 0, 8,34, 2, 10000
19, 2, 0, 7,28, 2, 10000
18, 2, 0, 5,25, 2, 10000
16, 2, 0, 7,25, 2, 10000
28, 2, 0, 5,35, 2, 10000
19, 2, 0, 4,25, 2, 10000
20, 2, 0, 4,26, 2, 10000
16, 2, 0, 6,24, 2, 10000
13, 2, 0, 7,22, 2, 10000
24, 2, 0, 9,35, 2, 10000
17, 2, 0, 8,27, 2, 10000
18, 2, 0, 4,24, 2, 10000
13, 2, 0, 5,20, 2, 10000
23, 2, 0, 6,31, 2, 10000
18, 2, 0, 3,23, 2, 10000
22, 2, 0, 5,29, 2, 10000
13, 2, 0, 3,18, 2, 10000
21, 2, 0, 3,26, 2, 10000
23, 2, 0, 6,31, 2, 10000
14, 2, 0, 8,24, 2, 10000
21, 2, 0, 3,26, 2, 10000
20, 2, 0, 4,26, 2, 10000
16, 2, 0, 3,21, 2, 10000
16, 2, 0, 5,23, 2, 10000
21, 2, 0, 1,24, 2, 10000
21, 2, 0, 3,26, 2, 10000
10, 2, 0, 1,13, 2, 10000
13, 2, 0, 8,23, 2, 10000
13, 2, 0, 5,20, 2, 10000
23, 2, 0, 4,29, 2, 10000
24, 2, 0, 9,35, 2, 10000
19, 2, 0, 8,29, 2, 10000
20, 2, 0, 5,27, 2, 10000
21, 2, 0, 5,28, 2, 10000
19, 2, 0, 3,24, 2, 10000
21, 2, 0, 2,25, 2, 10000
23, 2, 0, 7,32, 2, 10000
20, 2, 0, 7,29, 2, 10000
17, 2, 0, 5,24, 2, 10000
10, 2, 0, 6,18, 2, 10000
26, 2, 0, 5,33, 2, 10000
25, 2, 0, 2,29, 2, 10000
18, 2, 0, 5,25, 2, 10000
22, 2, 0, 4,28, 2, 10000
16, 2, 0, 10,28, 2, 10000
19, 2, 0, 5,26, 2, 10000
20, 2, 0, 4,26, 2, 10000
24, 2, 0, 2,28, 2, 10000
20, 2, 0, 3,25, 2, 10000
21, 2, 0, 4,27, 2, 10000
18, 2, 0, 4,24, 2, 10000
21, 2, 0, 9,32, 2, 10000
21, 2, 0, 9,32, 2, 10000
22, 2, 0, 5,29, 2, 10000
10, 2, 0, 3,15, 2, 10000
21, 2, 0, 12,35, 2, 10000
25, 2, 0, 4,31, 2, 10000
16, 2, 0, 6,24, 2, 10000
23, 2, 0, 7,32, 2, 10000
13, 2, 0, 8,23, 2, 10000
17, 2, 0, 6,25, 2, 10000
19, 2, 0, 6,27, 2, 10000
20, 2, 0, 7,29, 2, 10000
24, 2, 0, 5,31, 2, 10000
17, 2, 0, 3,22, 2, 10000
19, 2, 0, 6,27, 2, 10000
19, 2, 0, 5,26, 2, 10000
22, 2, 0, 4,28, 2, 10000
25, 2, 0, 2,29, 2, 10000
22, 2, 0, 5,29, 2, 10000
18, 2, 0, 5,25, 2, 10000
12, 2, 0, 8,22, 2, 10000
20, 2, 0, 2,24, 2, 10000
20, 2, 0, 7,29, 2, 10000
22, 2, 0, 6,30, 2, 10000
20, 2, 0, 2,24, 2, 10000
23, 2, 0, 7,32, 2, 10000
22, 2, 0, 9,33, 2, 10000
13, 2, 0, 4,19, 2, 10000
16, 2, 0, 7,25, 2, 10000
29, 2, 0, 2,33, 2, 10000
19, 2, 0, 7,28, 2, 10000
11, 2, 0, 5,18, 2, 10000
14, 2, 0, 6,22, 2, 10000
26, 2, 0, 5,33, 2, 10000
20, 2, 0, 6,28, 2, 10000
20, 2, 0, 5,27, 2, 10000
20, 2, 0, 8,30, 2, 10000
14, 2, 0, 9,25, 2, 10000
20, 2, 0, 4,26, 2, 10000
31, 2, 0, 7,40, 2, 10000
27, 2, 0, 9,38, 2, 10000
18, 2, 0, 6,26, 2, 10000
23, 2, 0, 6,31, 2, 10000
25, 2, 0, 6,33, 2, 10000
17, 2, 0, 5,24, 2, 10000
22, 2, 0, 6,30, 2, 10000
17, 2, 0, 8,27, 2, 10000
20, 2, 0, 5,27, 2, 10000
14, 2, 0, 8,24, 2, 10000
22, 2, 0, 6,30, 2, 10000
20, 2, 0, 6,28, 2, 10000
20, 2, 0, 9,31, 2, 10000
16, 2, 0, 5,23, 2, 10000
16, 2, 0, 8,26, 2, 10000
16, 2, 0, 5,23, 2, 10000
25, 2, 0, 8,35, 2, 10000
17, 2, 0, 4,23, 2, 10000
22, 2, 0, 3,27, 2, 10000
18, 2, 0, 9,29, 2, 10000
14, 2, 0, 6,22, 2, 10000
19, 2, 0, 5,26, 2, 10000
20, 2, 0, 9,31, 2, 10000
17, 2, 0, 5,24, 2, 10000
18, 2, 0, 5,25, 2, 10000
21, 2, 0, 4,27, 2, 10000
12, 2, 0, 4,18, 2, 10000
27, 2, 0, 3,32, 2, 10000
22, 2, 0, 9,33, 2, 10000
19, 2, 0, 5,26, 2, 10000
22, 2, 0, 4,28, 2, 10000
19, 2, 0, 10,31, 2, 10000
26, 2, 0, 0,28, 2, 10000
26, 2, 0, 6,34, 2, 10000
21, 2, 0, 8,31, 2, 10000
20, 2, 0, 1,23, 2, 10000
10, 2, 0, 5,17, 2, 10000
18, 2, 0, 8,28, 2, 10000
12, 2, 0, 5,19, 2, 10000
19, 2, 0, 5,26, 2, 10000
17, 2, 0, 5,24, 2, 10000
25, 2, 0, 9,36, 2, 10000
14, 2, 0, 3,19, 2, 10000
20, 2, 0, 6,28, 2, 10000
25, 2, 0, 6,33, 2, 10000
24, 2, 0, 5,31, 2, 10000
21, 2, 0, 2,25, 2, 10000
14, 2, 0, 9,25, 2, 10000
14, 2, 0, 6,22, 2, 10000
13, 2, 0, 5,20, 2, 10000
14, 2, 0, 4,20, 2, 10000
25, 2, 0, 8,35, 2, 10000
18, 2, 0, 4,24, 2, 10000
20, 2, 0, 10,32, 2, 10000
25, 2, 0, 5,32, 2, 10000
13, 2, 0, 4,19, 2, 10000
16, 2, 0, 7,25, 2, 10000
24, 2, 0, 9,35, 2, 10000
20, 2, 0, 7,29, 2, 10000
19, 2, 0, 9,30, 2, 10000
21, 2, 0, 3,26, 2, 10000
12, 2, 0, 9,23, 2, 10000
24, 2, 0, 5,31, 2, 10000
17, 2, 0, 8,27, 2, 10000
16, 2, 0, 5,23, 2, 10000
20, 2, 0, 6,28, 2, 10000
15, 2, 0, 1,18, 2, 10000
18, 2, 0, 5,25, 2, 10000
13, 2, 0, 6,21, 2, 10000
19, 2, 0, 5,26, 2, 10000
23, 2, 0, 6,31, 2, 10000
16, 2, 0, 4,22, 2, 10000
13, 2, 0, 12,27, 2, 10000
13, 2, 0, 8,23, 2, 10000
21, 2, 0, 6,29, 2, 10000
14, 2, 0, 6,22, 2, 10000
21, 2, 0, 6,29, 2, 10000
16, 2, 0, 5,23, 2, 10000
31, 2, 0, 6,39, 2, 10000
22, 2, 0, 3,27, 2, 10000
18, 2, 0, 12,32, 2, 10000
18, 2, 0, 11,31, 2, 10000
18, 2, 0, 2,22, 2, 10000
17, 2, 0, 7,26, 2, 10000
21, 2, 0, 4,27, 2, 10000
13, 2, 0, 4,19, 2, 10000
21, 2, 0, 1,24, 2, 10000
15, 2, 0, 6,23, 2, 10000
22, 2, 0, 5,29, 2, 10000
14, 2, 0, 4,20, 2, 10000
21, 2, 0, 5,28, 2, 10000
15, 2, 0, 9,26, 2, 10000
8, 2, 0, 4,14, 2, 10000
18, 2, 0, 3,23, 2, 10000
14, 2, 0, 2,18, 2, 10000
16, 2, 0, 4,22, 2, 10000
20, 2, 0, 5,27, 2, 10000
18, 2, 0, 6,26, 2, 10000
26, 2, 0, 2,30, 2, 10000
22, 2, 0, 8,32, 2, 10000
24, 2, 0, 4,30, 2, 10000
6, 2, 0, 6,14, 2, 10000
15, 2, 0, 5,22, 2, 10000
18, 2, 0, 5,25, 2, 10000
20, 2, 0, 6,28, 2, 10000
20, 2, 0, 7,29, 2, 10000
19, 2, 0, 6,27, 2, 10000
31, 2, 0, 4,37, 2, 10000
14, 2, 0, 2,18, 2, 10000
25, 2, 0, 9,36, 2, 10000
22, 2, 0, 10,34, 2, 10000
16, 2, 0, 2,20, 2, 10000
15, 2, 0, 0,17, 2, 10000
12, 2, 0, 4,18, 2, 10000
14, 2, 0, 3,19, 2, 10000
24, 2, 0, 2,28, 2, 10000
17, 2, 0, 5,24, 2, 10000
18, 2, 0, 5,25, 2, 10000
18, 2, 0, 7,27, 2, 10000
18, 2, 0, 8,28, 2, 10000
9, 2, 0, 6,17, 2, 10000
23, 2, 0, 7,32, 2, 10000
15, 2, 0, 5,22, 2, 10000
14, 2, 0, 3,19, 2, 10000
14, 2, 0, 7,23, 2, 10000
20, 2, 0, 5,27, 2, 10000
14, 2, 0, 5,21, 2, 10000
13, 2, 0, 6,21, 2, 10000
13, 2, 0, 7,22, 2, 10000
16, 2, 0, 3,21, 2, 10000
27, 2, 0, 9,38, 2, 10000
16, 2, 0, 6,24, 2, 10000
14, 2, 0, 5,21, 2, 10000
17, 2, 0, 7,26, 2, 10000
14, 2, 0, 8,24, 2, 10000
19, 2, 0, 8,29, 2, 10000
23, 2, 0, 2,27, 2, 10000
17, 2, 0, 5,24, 2, 10000
23, 2, 0, 3,28, 2, 10000
23, 2, 0, 3,28, 2, 10000
22, 2, 0, 5,29, 2, 10000
14, 2, 0, 8,24, 2, 10000
27, 2, 0, 6,35, 2, 10000
7, 2, 0, 1,10, 2, 10000
13, 2, 0, 7,22, 2, 10000
17, 2, 0, 11,30, 2, 10000
16, 2, 0, 6,24, 2, 10000
18, 2, 0, 6,26, 2, 10000
24, 2, 0, 5,31, 2, 10000
22, 2, 0, 5,29, 2, 10000
21, 2, 0, 6,29, 2, 10000
28, 2, 0, 3,33, 2, 10000
17, 2, 0, 11,30, 2, 10000
15, 2, 0, 7,24, 2, 10000
8, 2, 0, 8,18, 2, 10000
17, 2, 0, 6,25, 2, 10000
17, 2, 0, 2,21, 2, 10000
18, 2, 0, 4,24, 2, 10000
20, 2, 0, 6,28, 2, 10000
29, 2, 0, 4,35, 2, 10000
17, 2, 0, 6,25, 2, 10000
28, 2, 0, 6,36, 2, 10000
18, 2, 0, 9,29, 2, 10000
21, 2, 0, 4,27, 2, 10000
17, 2, 0, 5,24, 2, 10000
24, 2, 0, 4,30, 2, 10000
20, 2, 0, 6,28, 2, 10000
17, 2, 0, 2,21, 2, 10000
12, 2, 0, 7,21, 2, 10000
24, 2, 0, 6,32, 2, 10000
15, 2, 0, 3,20, 2, 10000
13, 2, 0, 5,20, 2, 10000
13, 2, 0, 3,18, 2, 10000
14, 2, 0, 3,19, 2, 10000
28, 2, 0, 5,35, 2, 10000
11, 2, 0, 7,20, 2, 10000
13, 2, 0, 6,21, 2, 10000
19, 2, 0, 6,27, 2, 10000
17, 2, 0, 6,25, 2, 10000
10, 2, 0, 3,15, 2, 10000
18, 2, 0, 7,27, 2, 10000
15, 2, 0, 12,29, 2, 10000
22, 2, 0, 4,28, 2, 10000
10, 2, 0, 4,16, 2, 10000
13, 2, 0, 8,23, 2, 10000
22, 2, 0, 4,28, 2, 10000
8, 2, 0, 4,14, 2, 10000
13, 2, 0, 9,24, 2, 10000
20, 2, 0, 7,29, 2, 10000
8, 2, 0, 5,15, 2, 10000
10, 2, 0, 3,15, 2, 10000
14, 2, 0, 5,21, 2, 10000
15, 2, 0, 4,21, 2, 10000
20, 2, 0, 6,28, 2, 10000
24, 2, 0, 5,31, 2, 10000
18, 2, 0, 2,22, 2, 10000
15, 2, 0, 2,19, 2, 10000
12, 2, 0, 5,19, 2, 10000
12, 2, 0, 3,17, 2, 10000
18, 2, 0, 12,32, 2, 10000
22, 2, 0, 2,26, 2, 10000
18, 2, 0, 5,25, 2, 10000
23, 2, 0, 4,29, 2, 10000
22, 2, 0, 2,26, 2, 10000
22, 2, 0, 3,27, 2, 10000
16, 2, 0, 4,22, 2, 10000
22, 2, 0, 3,27, 2, 10000
22, 2, 0, 4,28, 2, 10000
27, 2, 0, 7,36, 2, 10000
28, 2, 0, 7,37, 2, 10000
18, 2, 0, 5,25, 2, 10000
17, 2, 0, 7,26, 2, 10000
12, 2, 0, 2,16, 2, 10000
23, 2, 0, 6,31, 2, 10000
20, 2, 0, 4,26, 2, 10000
11, 2, 0, 12,25, 2, 10000
20, 2, 0, 4,26, 2, 10000
20, 2, 0, 1,23, 2, 10000
19, 2, 0, 6,27, 2, 10000
12, 2, 0, 6,20, 2, 10000
23, 2, 0, 9,34, 2, 10000
17, 2, 0, 7,26, 2, 10000
12, 2, 0, 6,20, 2, 10000
22, 2, 0, 8,32, 2, 10000
18, 2, 0, 8,28, 2, 10000
23, 2, 0, 4,29, 2, 10000
15, 2, 0, 7,24, 2, 10000
17, 2, 0, 2,21, 2, 10000
21, 2, 0, 5,28, 2, 10000
15, 2, 0, 2,19, 2, 10000
20, 2, 0, 6,28, 2, 10000
17, 2, 0, 4,23, 2, 10000
22, 2, 0, 5,29, 2, 10000
17, 2, 0, 7,26, 2, 10000
30, 2, 0, 6,38, 2, 10000
11, 2, 0, 8,21, 2, 10000
16, 2, 0, 4,22, 2, 10000
22, 2, 0, 6,30, 2, 10000
14, 2, 0, 6,22, 2, 10000
23, 2, 0, 2,27, 2, 10000
16, 2, 0, 6,24, 2, 10000
27, 2, 0, 4,33, 2, 10000
13, 2, 0, 7,22, 2, 10000
19, 2, 0, 2,23, 2, 10000
19, 2, 0, 6,27, 2, 10000
20, 2, 0, 8,30, 2, 10000
16, 2, 0, 10,28, 2, 10000
23, 2, 0, 7,32, 2, 10000
8, 2, 0, 3,13, 2, 10000
21, 2, 0, 3,26, 2, 10000
20, 2, 0, 5,27, 2, 10000
12, 2, 0, 5,19, 2, 10000
22, 2, 0, 5,29, 2, 10000
20, 2, 0, 2,24, 2, 10000
11, 2, 0, 7,20, 2, 10000
15, 2, 0, 4,21, 2, 10000
16, 2, 0, 4,22, 2, 10000
24, 2, 0, 12,38, 2, 10000
23, 2, 0, 4,29, 2, 10000
10, 2, 0, 10,22, 2, 10000
13, 2, 0, 6,21, 2, 10000
22, 2, 0, 6,30, 2, 10000
25, 2, 0, 9,36, 2, 10000
21, 2, 0, 10,33, 2, 10000
17, 2, 0, 7,26, 2, 10000
20, 2, 0, 7,29, 2, 10000
24, 2, 0, 4,30, 2, 10000
20, 2, 0, 10,32, 2, 10000
17, 2, 0, 4,23, 2, 10000
21, 2, 0, 7,30, 2, 10000
15, 2, 0, 1,18, 2, 10000
18, 2, 0, 4,24, 2, 10000
13, 2, 0, 12,27, 2, 10000
17, 2, 0, 6,25, 2, 10000
16, 2, 0, 7,25, 2, 10000
26, 2, 0, 7,35, 2, 10000
18, 2, 0, 7,27, 2, 10000
26, 2, 0, 6,34, 2, 10000
16, 2, 0, 4,22, 2, 10000
26, 2, 0, 2,30, 2, 10000
22, 2, 0, 7,31, 2, 10000
25, 2, 0, 4,31, 2, 10000
11, 2, 0, 8,21, 2, 10000
12, 2, 0, 4,18, 2, 10000
16, 2, 0, 7,25, 2, 10000
10, 2, 0, 4,16, 2, 10000
17, 2, 0, 1,20, 2, 10000
25, 2, 0, 7,34, 2, 10000
20, 2, 0, 7,29, 2, 10000
24, 2, 0, 5,31, 2, 10000
21, 2, 0, 5,28, 2, 10000
17, 2, 0, 5,24, 2, 10000
10, 2, 0, 4,16, 2, 10000
19, 2, 0, 2,23, 2, 10000
13, 2, 0, 6,21, 2, 10000
25, 2, 0, 7,34, 2, 10000
9, 2, 0, 10,21, 2, 10000
13, 2, 0, 4,19, 2, 10000
20, 2, 0, 3,25, 2, 10000
15, 2, 0, 2,19, 2, 10000
19, 2, 0, 4,25, 2, 10000
12, 2, 0, 8,22, 2, 10000
16, 2, 0, 5,23, 2, 10000
13, 2, 0, 2,17, 2, 10000
23, 2, 0, 1,26, 2, 10000
20, 2, 0, 6,28, 2, 10000
18, 2, 0, 8,28, 2, 10000
17, 2, 0, 3,22, 2, 10000
13, 2, 0, 5,20, 2, 10000
17, 2, 0, 6,25, 2, 10000
24, 2, 0, 9,35, 2, 10000
22, 2, 0, 3,27, 2, 10000
20, 2, 0, 3,25, 2, 10000
18, 2, 0, 5,25, 2, 10000
25, 2, 0, 6,33, 2, 10000
26, 2, 0, 6,34, 2, 10000
11, 2, 0, 6,19, 2, 10000
16, 2, 0, 6,24, 2, 10000
17, 2, 0, 1,20, 2, 10000
15, 2, 0, 5,22, 2, 10000
17, 2, 0, 5,24, 2, 10000
13, 2, 0, 4,19, 2, 10000
17, 2, 0, 6,25, 2, 10000
16, 2, 0, 6,24, 2, 10000
22, 2, 0, 2,26, 2, 10000
23, 2, 0, 3,28, 2, 10000
15, 2, 0, 4,21, 2, 10000
19, 2, 0, 4,25, 2, 10000
14, 2, 0, 10,26, 2, 10000
11, 2, 0, 6,19, 2, 10000
16, 2, 0, 5,23, 2, 10000
19, 2, 0, 7,28, 2, 10000
20, 2, 0, 2,24, 2, 10000
14, 2, 0, 4,20, 2, 10000
10, 2, 0, 1,13, 2, 10000
19, 2, 0, 11,32, 2, 10000
18, 2, 0, 3,23, 2, 10000
18, 2, 0, 2,22, 2, 10000
22, 2, 0, 6,30, 2, 10000
9, 2, 0, 3,14, 2, 10000
15, 2, 0, 6,23, 2, 10000
14, 2, 0, 5,21, 2, 10000
15, 2, 0, 4,21, 2, 10000
17, 2, 0, 5,24, 2, 10000
19, 2, 0, 5,26, 2, 10000
15, 2, 0, 9,26, 2, 10000
12, 2, 0, 4,18, 2, 10000
17, 2, 0, 6,25, 2, 10000
11, 2, 0, 3,16, 2, 10000
20, 2, 0, 2,24, 2, 10000
20, 2, 0, 3,25, 2, 10000
25, 2, 0, 8,35, 2, 10000
15, 2, 0, 1,18, 2, 10000
19, 2, 0, 4,25, 2, 10000
19, 2, 0, 0,21, 2, 10000
24, 2, 0, 5,31, 2, 10000
26, 2, 0, 11,39, 2, 10000
20, 2, 0, 7,29, 2, 10000
26, 2, 0, 4,32, 2, 10000
12, 2, 0, 4,18, 2, 10000
17, 2, 0, 7,26, 2, 10000
17, 2, 0, 6,25, 2, 10000
22, 2, 0, 4,28, 2, 10000
17, 2, 0, 2,21, 2, 10000
14, 2, 0, 13,29, 2, 10000
15, 2, 0, 2,19, 2, 10000
25, 2, 0, 5,32, 2, 10000
19, 2, 0, 4,25, 2, 10000
13, 2, 0, 4,19, 2, 10000
12, 2, 0, 1,15, 2, 10000
12, 2, 0, 5,19, 2, 10000
14, 2, 0, 3,19, 2, 10000
13, 2, 0, 12,27, 2, 10000
25, 2, 0, 5,32, 2, 10000
16, 2, 0, 9,27, 2, 10000
17, 2, 0, 4,23, 2, 10000
12, 2, 0, 7,21, 2, 10000
14, 2, 0, 4,20, 2, 10000
14, 2, 0, 8,24, 2, 10000
16, 2, 0, 6,24, 2, 10000
18, 2, 0, 4,24, 2, 10000
12, 2, 0, 6,20, 2, 10000
18, 2, 0, 3,23, 2, 10000
19, 2, 0, 2,23, 2, 10000
14, 2, 0, 2,18, 2, 10000
13, 2, 0, 3,18, 2, 10000
8, 2, 0, 9,19, 2, 10000
16, 2, 0, 5,23, 2, 10000
15, 2, 0, 5,22, 2, 10000
16, 2, 0, 2,20, 2, 10000
11, 2, 0, 3,16, 2, 10000
20, 2, 0, 12,34, 2, 10000
20, 2, 0, 5,27, 2, 10000
18, 2, 0, 5,25, 2, 10000
19, 2, 0, 7,28, 2, 10000
19, 2, 0, 7,28, 2, 10000
16, 2, 0, 5,23, 2, 10000
24, 2, 0, 4,30, 2, 10000
28, 2, 0, 4,34, 2, 10000
14, 2, 0, 8,24, 2, 10000
21, 2, 0, 5,28, 2, 10000
18, 2, 0, 7,27, 2, 10000
16, 2, 0, 8,26, 2, 10000
9, 2, 0, 4,15, 2, 10000
21, 2, 0, 5,28, 2, 10000
16, 2, 0, 4,22, 2, 10000
10, 2, 0, 7,19, 2, 10000
15, 2, 0, 8,25, 2, 10000
16, 2, 0, 5,23, 2, 10000
9, 2, 0, 7,18, 2, 10000
18, 2, 0, 10,30, 2, 10000
20, 2, 0, 4,26, 2, 10000
11, 2, 0, 7,20, 2, 10000
21, 2, 0, 6,29, 2, 10000
20, 2, 0, 4,26, 2, 10000
23, 2, 0, 4,29, 2, 10000
20, 2, 0, 3,25, 2, 10000
13, 2, 0, 7,22, 2, 10000
12, 2, 0, 5,19, 2, 10000
20, 2, 0, 6,28, 2, 10000
8, 2, 0, 5,15, 2, 10000
13, 2, 0, 5,20, 2, 10000
15, 2, 0, 4,21, 2, 10000
14, 2, 0, 3,19, 2, 10000
18, 2, 0, 4,24, 2, 10000
15, 2, 0, 4,21, 2, 10000
16, 2, 0, 7,25, 2, 10000
21, 2, 0, 7,30, 2, 10000
18, 2, 0, 9,29, 2, 10000
18, 2, 0, 9,29, 2, 10000
19, 2, 0, 7,28, 2, 10000
12, 2, 0, 7,21, 2, 10000
23, 2, 0, 5,30, 2, 10000
20, 2, 0, 4,26, 2, 10000
18, 2, 0, 5,25, 2, 10000
13, 2, 0, 4,19, 2, 10000
13, 2, 0, 6,21, 2, 10000
19, 2, 0, 6,27, 2, 10000
27, 2, 0, 8,37, 2, 10000
18, 2, 0, 5,25, 2, 10000
16, 2, 0, 6,24, 2, 10000
19, 2, 0, 7,28, 2, 10000
12, 2, 0, 2,16, 2, 10000
16, 2, 0, 5,23, 2, 10000
17, 2, 0, 4,23, 2, 10000
17, 2, 0, 7,26, 2, 10000
15, 2, 0, 9,26, 2, 10000
18, 2, 0, 4,24, 2, 10000
16, 2, 0, 5,23, 2, 10000
15, 2, 0, 9,26, 2, 10000
16, 2, 0, 9,27, 2, 10000
20, 2, 0, 2,24, 2, 10000
15, 2, 0, 7,24, 2, 10000
20, 2, 0, 4,26, 2, 10000
9, 2, 0, 9,20, 2, 10000
30, 2, 0, 2,34, 2, 10000
18, 2, 0, 4,24, 2, 10000
14, 2, 0, 6,22, 2, 10000
23, 2, 0, 7,32, 2, 10000
19, 2, 0, 7,28, 2, 10000
15, 2, 0, 5,22, 2, 10000
14, 2, 0, 5,21, 2, 10000
13, 2, 0, 7,22, 2, 10000
14, 2, 0, 2,18, 2, 10000
18, 2, 0, 6,26, 2, 10000
16, 2, 0, 9,27, 2, 10000
8, 2, 0, 8,18, 2, 10000
21, 2, 0, 5,28, 2, 10000
17, 2, 0, 7,26, 2, 10000
15, 2, 0, 3,20, 2, 10000
15, 2, 0, 5,22, 2, 10000
27, 2, 0, 4,33, 2, 10000
16, 2, 0, 4,22, 2, 10000
27, 2, 0, 6,35, 2, 10000
27, 2, 0, 4,33, 2, 10000
23, 2, 0, 3,28, 2, 10000
15, 2, 0, 3,20, 2, 10000
20, 2, 0, 9,31, 2, 10000
22, 2, 0, 6,30, 2, 10000
20, 2, 0, 6,28, 2, 10000
13, 2, 0, 3,18, 2, 10000
19, 2, 0, 2,23, 2, 10000
17, 2, 0, 4,23, 2, 10000
12, 2, 0, 2,16, 2, 10000
28, 2, 0, 1,31, 2, 10000
25, 2, 0, 7,34, 2, 10000
9, 2, 0, 7,18, 2, 10000
15, 2, 0, 4,21, 2, 10000
17, 2, 0, 3,22, 2, 10000
11, 2, 0, 4,17, 2, 10000
11, 2, 0, 3,16, 2, 10000
11, 2, 0, 7,20, 2, 10000
16, 2, 0, 6,24, 2, 10000
14, 2, 0, 4,20, 2, 10000
12, 2, 0, 3,17, 2, 10000
12, 2, 0, 5,19, 2, 10000
15, 2, 0, 4,21, 2, 10000
10, 2, 0, 3,15, 2, 10000
13, 2, 0, 4,19, 2, 10000
15, 2, 0, 6,23, 2, 10000
20, 2, 0, 3,25, 2, 10000
21, 2, 0, 5,28, 2, 10000
18, 2, 0, 7,27, 2, 10000
23, 2, 0, 7,32, 2, 10000
14, 2, 0, 4,20, 2, 10000
15, 2, 0, 6,23, 2, 10000
19, 2, 0, 8,29, 2, 10000
28, 2, 0, 6,36, 2, 10000
12, 2, 0, 5,19, 2, 10000
14, 2, 0, 5,21, 2, 10000
15, 2, 0, 7,24, 2, 10000
21, 2, 0, 8,31, 2, 10000
15, 2, 0, 2,19, 2, 10000
16, 2, 0, 8,26, 2, 10000
22, 2, 0, 7,31, 2, 10000
22, 2, 0, 5,29, 2, 10000
15, 2, 0, 5,22, 2, 10000
18, 2, 0, 11,31, 2, 10000
18, 2, 0, 5,25, 2, 10000
9, 2, 0, 7,18, 2, 10000
16, 2, 0, 6,24, 2, 10000
10, 2, 0, 2,14, 2, 10000
12, 2, 0, 5,19, 2, 10000
13, 2, 0, 6,21, 2, 10000
15, 2, 0, 5,22, 2, 10000
20, 2, 0, 3,25, 2, 10000
18, 2, 0, 5,25, 2, 10000
15, 2, 0, 4,21, 2, 10000
15, 2, 0, 9,26, 2, 10000
19, 2, 0, 6,27, 2, 10000
10, 2, 0, 6,18, 2, 10000
20, 2, 0, 10,32, 2, 10000
20, 2, 0, 5,27, 2, 10000
17, 2, 0, 8,27, 2, 10000
20, 2, 0, 3,25, 2, 10000
19, 2, 0, 5,26, 2, 10000
18, 2, 0, 5,25, 2, 10000
14, 2, 0, 3,19, 2, 10000
19, 2, 0, 7,28, 2, 10000
9, 2, 0, 6,17, 2, 10000
20, 2, 0, 4,26, 2, 10000
16, 2, 0, 5,23, 2, 10000
16, 2, 0, 6,24, 2, 10000
13, 2, 0, 4,19, 2, 10000
22, 2, 0, 2,26, 2, 10000
13, 2, 0, 3,18, 2, 10000
23, 2, 0, 8,33, 2, 10000
18, 2, 0, 4,24, 2, 10000
14, 2, 0, 6,22, 2, 10000
10, 2, 0, 10,22, 2, 10000
16, 2, 0, 5,23, 2, 10000
14, 2, 0, 3,19, 2, 10000
14, 2, 0, 5,21, 2, 10000
10, 2, 0, 5,17, 2, 10000
13, 2, 0, 8,23, 2, 10000
18, 2, 0, 4,24, 2, 10000
13, 2, 0, 7,22, 2, 10000
23, 2, 0, 4,29, 2, 10000
14, 2, 0, 4,20, 2, 10000
14, 2, 0, 4,20, 2, 10000
18, 2, 0, 5,25, 2, 10000
15, 2, 0, 3,20, 2, 10000
13, 2, 0, 5,20, 2, 10000
8, 2, 0, 3,13, 2, 10000
22, 2, 0, 7,31, 2, 10000
9, 2, 0, 2,13, 2, 10000
16, 2, 0, 8,26, 2, 10000
18, 2, 0, 2,22, 2, 10000
15, 2, 0, 4,21, 2, 10000
15, 2, 0, 3,20, 2, 10000
11, 2, 0, 6,19, 2, 10000
14, 2, 0, 5,21, 2, 10000
8, 2, 0, 5,15, 2, 10000
18, 2, 0, 7,27, 2, 10000
12, 2, 0, 9,23, 2, 10000
22, 2, 0, 9,33, 2, 10000
22, 2, 0, 1,25, 2, 10000
21, 2, 0, 7,30, 2, 10000
11, 2, 0, 3,16, 2, 10000
16, 2, 0, 5,23, 2, 10000
10, 2, 0, 6,18, 2, 10000
17, 2, 0, 2,21, 2, 10000
15, 2, 0, 4,21, 2, 10000
19, 2, 0, 5,26, 2, 10000
25, 2, 0, 8,35, 2, 10000
12, 2, 0, 8,22, 2, 10000
20, 2, 0, 6,28, 2, 10000
16, 2, 0, 4,22, 2, 10000
15, 2, 0, 5,22, 2, 10000
16, 2, 0, 10,28, 2, 10000
17, 2, 0, 6,25, 2, 10000
20, 2, 0, 5,27, 2, 10000
17, 2, 0, 3,22, 2, 10000
22, 2, 0, 1,25, 2, 10000
16, 2, 0, 7,25, 2, 10000
16, 2, 0, 8,26, 2, 10000
18, 2, 0, 3,23, 2, 10000
15, 2, 0, 4,21, 2, 10000
13, 2, 0, 2,17, 2, 10000
10, 2, 0, 7,19, 2, 10000
13, 2, 0, 4,19, 2, 10000
20, 2, 0, 7,29, 2, 10000
18, 2, 0, 5,25, 2, 10000
9, 2, 0, 6,17, 2, 10000
11, 2, 0, 4,17, 2, 10000
12, 2, 0, 5,19, 2, 10000
17, 2, 0, 5,24, 2, 10000
11, 2, 0, 3,16, 2, 10000
16, 2, 0, 2,20, 2, 10000
24, 2, 0, 5,31, 2, 10000
18, 2, 0, 7,27, 2, 10000
22, 2, 0, 3,27, 2, 10000
18, 2, 0, 4,24, 2, 10000
15, 2, 0, 6,23, 2, 10000
7, 2, 0, 2,11, 2, 10000
14, 2, 0, 1,17, 2, 10000
15, 2, 0, 6,23, 2, 10000
14, 2, 0, 3,19, 2, 10000
14, 2, 0, 3,19, 2, 10000
16, 2, 0, 5,23, 2, 10000
9, 2, 0, 8,19, 2, 10000
7, 2, 0, 4,13, 2, 10000
9, 2, 0, 3,14, 2, 10000
20, 2, 0, 5,27, 2, 10000
21, 2, 0, 9,32, 2, 10000
21, 2, 0, 5,28, 2, 10000
11, 2, 0, 5,18, 2, 10000
22, 2, 0, 3,27, 2, 10000
11, 2, 0, 3,16, 2, 10000
20, 2, 0, 2,24, 2, 10000
7, 2, 0, 6,15, 2, 10000
9, 2, 0, 2,13, 2, 10000
16, 2, 0, 6,24, 2, 10000
19, 2, 0, 6,27, 2, 10000
11, 2, 0, 5,18, 2, 10000
18, 2, 0, 6,26, 2, 10000
12, 2, 0, 7,21, 2, 10000
13, 2, 0, 0,15, 2, 10000
16, 2, 0, 6,24, 2, 10000
22, 2, 0, 2,26, 2, 10000
17, 2, 0, 11,30, 2, 10000
12, 2, 0, 6,20, 2, 10000
14, 2, 0, 10,26, 2, 10000
23, 2, 0, 5,30, 2, 10000
20, 2, 0, 5,27, 2, 10000
13, 2, 0, 7,22, 2, 10000
15, 2, 0, 5,22, 2, 10000
10, 2, 0, 8,20, 2, 10000
12, 2, 0, 2,16, 2, 10000
16, 2, 0, 7,25, 2, 10000
21, 2, 0, 3,26, 2, 10000
12, 2, 0, 5,19, 2, 10000
14, 2, 0, 4,20, 2, 10000
23, 2, 0, 8,33, 2, 10000
17, 2, 0, 5,24, 2, 10000
22, 2, 0, 2,26, 2, 10000
11, 2, 0, 5,18, 2, 10000
17, 2, 0, 4,23, 2, 10000
15, 2, 0, 3,20, 2, 10000
17, 2, 0, 1,20, 2, 10000
16, 2, 0, 9,27, 2, 10000
18, 2, 0, 8,28, 2, 10000
22, 2, 0, 3,27, 2, 10000
17, 2, 0, 5,24, 2, 10000
13, 2, 0, 5,20, 2, 10000
13, 2, 0, 10,25, 2, 10000
19, 2, 0, 11,32, 2, 10000
17, 2, 0, 5,24, 2, 10000
17, 2, 0, 6,25, 2, 10000
11, 2, 0, 0,13, 2, 10000
15, 2, 0, 3,20, 2, 10000
16, 2, 0, 1,19, 2, 10000
21, 2, 0, 6,29, 2, 10000
19, 2, 0, 1,22, 2, 10000
19, 2, 0, 7,28, 2, 10000
16, 2, 0, 5,23, 2, 10000
19, 2, 0, 2,23, 2, 10000
18, 2, 0, 7,27, 2, 10000
13, 2, 0, 2,17, 2, 10000
20, 2, 0, 7,29, 2, 10000
14, 2, 0, 3,19, 2, 10000
11, 2, 0, 7,20, 2, 10000
14, 2, 0, 6,22, 2, 10000
11, 2, 0, 6,19, 2, 10000
8, 2, 0, 6,16, 2, 10000
23, 2, 0, 5,30, 2, 10000
17, 2, 0, 6,25, 2, 10000
13, 2, 0, 7,22, 2, 10000
18, 2, 0, 3,23, 2, 10000
11, 2, 0, 4,17, 2, 10000
12, 2, 0, 2,16, 2, 10000
17, 2, 0, 3,22, 2, 10000
16, 2, 0, 4,22, 2, 10000
12, 2, 0, 11,25, 2, 10000
20, 2, 0, 8,30, 2, 10000
23, 2, 0, 5,30, 2, 10000
11, 2, 0, 2,15, 2, 10000
11, 2, 0, 7,20, 2, 10000
19, 2, 0, 7,28, 2, 10000
12, 2, 0, 9,23, 2, 10000
10, 2, 0, 7,19, 2, 10000
14, 2, 0, 1,17, 2, 10000
20, 2, 0, 7,29, 2, 10000
18, 2, 0, 7,27, 2, 10000
13, 2, 0, 3,18, 2, 10000
24, 2, 0, 7,33, 2, 10000
8, 2, 0, 2,12, 2, 10000
9, 2, 0, 6,17, 2, 10000
25, 2, 0, 2,29, 2, 10000
14, 2, 0, 2,18, 2, 10000
11, 2, 0, 5,18, 2, 10000
20, 2, 0, 11,33, 2, 10000
15, 2, 0, 5,22, 2, 10000
15, 2, 0, 4,21, 2, 10000
21, 2, 0, 4,27, 2, 10000
15, 2, 0, 3,20, 2, 10000
11, 2, 0, 6,19, 2, 10000
17, 2, 0, 5,24, 2, 10000
14, 2, 0, 7,23, 2, 10000
17, 2, 0, 3,22, 2, 10000
10, 2, 0, 3,15, 2, 10000
14, 2, 0, 6,22, 2, 10000
11, 2, 0, 4,17, 2, 10000
19, 2, 0, 6,27, 2, 10000
18, 2, 0, 11,31, 2, 10000
10, 2, 0, 1,13, 2, 10000
17, 2, 0, 8,27, 2, 10000
10, 2, 0, 5,17, 2, 10000
23, 2, 0, 3,28, 2, 10000
14, 2, 0, 2,18, 2, 10000
14, 2, 0, 5,21, 2, 10000
13, 2, 0, 3,18, 2, 10000
7, 2, 0, 4,13, 2, 10000
20, 2, 0, 3,25, 2, 10000
20, 2, 0, 6,28, 2, 10000
13, 2, 0, 6,21, 2, 10000
13, 2, 0, 5,20, 2, 10000
16, 2, 0, 3,21, 2, 10000
14, 2, 0, 5,21, 2, 10000
11, 2, 0, 3,16, 2, 10000
17, 2, 0, 6,25, 2, 10000
12, 2, 0, 3,17, 2, 10000
24, 2, 0, 5,31, 2, 10000
11, 2, 0, 1,14, 2, 10000
18, 2, 0, 5,25, 2, 10000
12, 2, 0, 6,20, 2, 10000
15, 2, 0, 12,29, 2, 10000
13, 2, 0, 6,21, 2, 10000
15, 2, 0, 5,22, 2, 10000
13, 2, 0, 3,18, 2, 10000
15, 2, 0, 4,21, 2, 10000
15, 2, 0, 3,20, 2, 10000
8, 2, 0, 4,14, 2, 10000
21, 2, 0, 1,24, 2, 10000
17, 2, 0, 3,22, 2, 10000
12, 2, 0, 5,19, 2, 10000
16, 2, 0, 3,21, 2, 10000
22, 2, 0, 4,28, 2, 10000
18, 2, 0, 2,22, 2, 10000
16, 2, 0, 9,27, 2, 10000
13, 2, 0, 7,22, 2, 10000
18, 2, 0, 4,24, 2, 10000
21, 2, 0, 8,31, 2, 10000
25, 2, 0, 7,34, 2, 10000
11, 2, 0, 6,19, 2, 10000
19, 2, 0, 2,23, 2, 10000
16, 2, 0, 4,22, 2, 10000
19, 2, 0, 4,25, 2, 10000
13, 2, 0, 4,19, 2, 10000
15, 2, 0, 6,23, 2, 10000
9, 2, 0, 3,14, 2, 10000
14, 2, 0, 6,22, 2, 10000
5, 2, 0, 10,17, 2, 10000
12, 2, 0, 6,20, 2, 10000
21, 2, 0, 5,28, 2, 10000
15, 2, 0, 7,24, 2, 10000
11, 2, 0, 5,18, 2, 10000
12, 2, 0, 7,21, 2, 10000
10, 2, 0, 7,19, 2, 10000
14, 2, 0, 3,19, 2, 10000
18, 2, 0, 6,26, 2, 10000
18, 2, 0, 5,25, 2, 10000
18, 2, 0, 7,27, 2, 10000
12, 2, 0, 5,19, 2, 10000
20, 2, 0, 6,28, 2, 10000
7, 2, 0, 4,13, 2, 10000
23, 2, 0, 3,28, 2, 10000
17, 2, 0, 3,22, 2, 10000
14, 2, 0, 3,19, 2, 10000
16, 2, 0, 5,23, 2, 10000
18, 2, 0, 3,23, 2, 10000
10, 2, 0, 7,19, 2, 10000
11, 2, 0, 2,15, 2, 10000
24, 2, 0, 6,32, 2, 10000
14, 2, 0, 9,25, 2, 10000
14, 2, 0, 2,18, 2, 10000
14, 2, 0, 4,20, 2, 10000
16, 2, 0, 7,25, 2, 10000
12, 2, 0, 0,14, 2, 10000
9, 2, 0, 5,16, 2, 10000
13, 2, 0, 6,21, 2, 10000
17, 2, 0, 6,25, 2, 10000
12, 2, 0, 5,19, 2, 10000
12, 2, 0, 7,21, 2, 10000
14, 2, 0, 4,20, 2, 10000
17, 2, 0, 2,21, 2, 10000
15, 2, 0, 6,23, 2, 10000
20, 2, 0, 1,23, 2, 10000
12, 2, 0, 3,17, 2, 10000
18, 2, 0, 7,27, 2, 10000
15, 2, 0, 5,22, 2, 10000
13, 2, 0, 2,17, 2, 10000
16, 2, 0, 6,24, 2, 10000
17, 2, 0, 3,22, 2, 10000
12, 2, 0, 8,22, 2, 10000
17, 2, 0, 7,26, 2, 10000
13, 2, 0, 3,18, 2, 10000
10, 2, 0, 6,18, 2, 10000
11, 2, 0, 5,18, 2, 10000
19, 2, 0, 4,25, 2, 10000
11, 2, 0, 8,21, 2, 10000
17, 2, 0, 4,23, 2, 10000
20, 2, 0, 5,27, 2, 10000
15, 2, 0, 9,26, 2, 10000
16, 2, 0, 6,24, 2, 10000
17, 2, 0, 7,26, 2, 10000
16, 2, 0, 4,22, 2, 10000
14, 2, 0, 3,19, 2, 10000
8, 2, 0, 6,16, 2, 10000
6, 2, 0, 5,13, 2, 10000
14, 2, 0, 6,22, 2, 10000
13, 2, 0, 5,20, 2, 10000
13, 2, 0, 3,18, 2, 10000
18, 2, 0, 7,27, 2, 10000
21, 2, 0, 4,27, 2, 10000
18, 2, 0, 8,28, 2, 10000
20, 2, 0, 1,23, 2, 10000
17, 2, 0, 5,24, 2, 10000
10, 2, 0, 4,16, 2, 10000
15, 2, 0, 8,25, 2, 10000
9, 2, 0, 4,15, 2, 10000
8, 2, 0, 6,16, 2, 10000
9, 2, 0, 5,16, 2, 10000
17, 2, 0, 5,24, 2, 10000
18, 2, 0, 8,28, 2, 10000
18, 2, 0, 5,25, 2, 10000
11, 2, 0, 7,20, 2, 10000
12, 2, 0, 5,19, 2, 10000
17, 2, 0, 8,27, 2, 10000
13, 2, 0, 7,22, 2, 10000
17, 2, 0, 4,23, 2, 10000
18, 2, 0, 7,27, 2, 10000
16, 2, 0, 5,23, 2, 10000
29, 2, 0, 4,35, 2, 10000
14, 2, 0, 5,21, 2, 10000
13, 2, 0, 5,20, 2, 10000
6, 2, 0, 7,15, 2, 10000
19, 2, 0, 3,24, 2, 10000
12, 2, 0, 5,19, 2, 10000
21, 2, 0, 2,25, 2, 10000
12, 2, 0, 3,17, 2, 10000
13, 2, 0, 7,22, 2, 10000
13, 2, 0, 5,20, 2, 10000
17, 2, 0, 8,27, 2, 10000
17, 2, 0, 7,26, 2, 10000
12, 2, 0, 6,20, 2, 10000
17, 2, 0, 2,21, 2, 10000
15, 2, 0, 2,19, 2, 10000
21, 2, 0, 4,27, 2, 10000
19, 2, 0, 8,29, 2, 10000
20, 2, 0, 4,26, 2, 10000
14, 2, 0, 5,21, 2, 10000
14, 2, 0, 4,20, 2, 10000
14, 2, 0, 4,20, 2, 10000
20, 2, 0, 3,25, 2, 10000
8, 2, 0, 1,11, 2, 10000
8, 2, 0, 3,13, 2, 10000
20, 2, 0, 4,26, 2, 10000
18, 2, 0, 6,26, 2, 10000
23, 2, 0, 6,31, 2, 10000
12, 2, 0, 5,19, 2, 10000
19, 2, 0, 5,26, 2, 10000
14, 2, 0, 5,21, 2, 10000
11, 2, 0, 6,19, 2, 10000
14, 2, 0, 3,19, 2, 10000
17, 2, 0, 2,21, 2, 10000
6, 2, 0, 3,11, 2, 10000
16, 2, 0, 3,21, 2, 10000
18, 2, 0, 2,22, 2, 10000
14, 2, 0, 2,18, 2, 10000
14, 2, 0, 3,19, 2, 10000
16, 2, 0, 9,27, 2, 10000
12, 2, 0, 5,19, 2, 10000
18, 2, 0, 3,23, 2, 10000
13, 2, 0, 6,21, 2, 10000
13, 2, 0, 9,24, 2, 10000
10, 2, 0, 3,15, 2, 10000
26, 2, 0, 4,32, 2, 10000
17, 2, 0, 2,21, 2, 10000
14, 2, 0, 4,20, 2, 10000
18, 2, 0, 1,21, 2, 10000
19, 2, 0, 4,25, 2, 10000
16, 2, 0, 3,21, 2, 10000
12, 2, 0, 2,16, 2, 10000
12, 2, 0, 4,18, 2, 10000
10, 2, 0, 5,17, 2, 10000
8, 2, 0, 8,18, 2, 10000
19, 2, 0, 4,25, 2, 10000
12, 2, 0, 2,16, 2, 10000
25, 2, 0, 3,30, 2, 10000
15, 2, 0, 6,23, 2, 10000
21, 2, 0, 5,28, 2, 10000
3, 2, 0, 2,7, 2, 10000
14, 2, 0, 3,19, 2, 10000
14, 2, 0, 2,18, 2, 10000
17, 2, 0, 3,22, 2, 10000
20, 2, 0, 7,29, 2, 10000
20, 2, 0, 4,26, 2, 10000
17, 2, 0, 2,21, 2, 10000
14, 2, 0, 6,22, 2, 10000
18, 2, 0, 4,24, 2, 10000
19, 2, 0, 9,30, 2, 10000
19, 2, 0, 6,27, 2, 10000
16, 2, 0, 5,23, 2, 10000
18, 2, 0, 5,25, 2, 10000
10, 2, 0, 3,15, 2, 10000
5, 2, 0, 5,12, 2, 10000
6, 2, 0, 3,11, 2, 10000
22, 2, 0, 2,26, 2, 10000
15, 2, 0, 8,25, 2, 10000
13, 2, 0, 3,18, 2, 10000
16, 2, 0, 11,29, 2, 10000
17, 2, 0, 7,26, 2, 10000
14, 2, 0, 8,24, 2, 10000
14, 2, 0, 6,22, 2, 10000
19, 2, 0, 2,23, 2, 10000
14, 2, 0, 6,22, 2, 10000
16, 2, 0, 7,25, 2, 10000
22, 2, 0, 7,31, 2, 10000
18, 2, 0, 7,27, 2, 10000
12, 2, 0, 1,15, 2, 10000
18, 2, 0, 7,27, 2, 10000
10, 2, 0, 5,17, 2, 10000
8, 2, 0, 4,14, 2, 10000
21, 2, 0, 4,27, 2, 10000
27, 2, 0, 8,37, 2, 10000
8, 2, 0, 2,12, 2, 10000
12, 2, 0, 9,23, 2, 10000
13, 2, 0, 2,17, 2, 10000
13, 2, 0, 6,21, 2, 10000
15, 2, 0, 8,25, 2, 10000
15, 2, 0, 5,22, 2, 10000
23, 2, 0, 2,27, 2, 10000
18, 2, 0, 4,24, 2, 10000
14, 2, 0, 5,21, 2, 10000
9, 2, 0, 5,16, 2, 10000
13, 2, 0, 4,19, 2, 10000
26, 2, 0, 6,34, 2, 10000
16, 2, 0, 3,21, 2, 10000
16, 2, 0, 7,25, 2, 10000
20, 2, 0, 5,27, 2, 10000
10, 2, 0, 5,17, 2, 10000
9, 2, 0, 1,12, 2, 10000
12, 2, 0, 5,19, 2, 10000
17, 2, 0, 3,22, 2, 10000
14, 2, 0, 6,22, 2, 10000
10, 2, 0, 6,18, 2, 10000
8, 2, 0, 5,15, 2, 10000
9, 2, 0, 3,14, 2, 10000
13, 2, 0, 8,23, 2, 10000
19, 2, 0, 7,28, 2, 10000
10, 2, 0, 8,20, 2, 10000
16, 2, 0, 4,22, 2, 10000
18, 2, 0, 6,26, 2, 10000
12, 2, 0, 4,18, 2, 10000
7, 2, 0, 6,15, 2, 10000
17, 2, 0, 3,22, 2, 10000
15, 2, 0, 6,23, 2, 10000
15, 2, 0, 3,20, 2, 10000
13, 2, 0, 1,16, 2, 10000
11, 2, 0, 4,17, 2, 10000
13, 2, 0, 5,20, 2, 10000
15, 2, 0, 4,21, 2, 10000
15, 2, 0, 6,23, 2, 10000
17, 2, 0, 0,19, 2, 10000
14, 2, 0, 5,21, 2, 10000
15, 2, 0, 7,24, 2, 10000
7, 2, 0, 7,16, 2, 10000
13, 2, 0, 0,15, 2, 10000
13, 2, 0, 3,18, 2, 10000
19, 2, 0, 7,28, 2, 10000
12, 2, 0, 2,16, 2, 10000
16, 2, 0, 3,21, 2, 10000
16, 2, 0, 9,27, 2, 10000
16, 2, 0, 7,25, 2, 10000
17, 2, 0, 4,23, 2, 10000
14, 2, 0, 3,19, 2, 10000
19, 2, 0, 8,29, 2, 10000
10, 2, 0, 8,20, 2, 10000
13, 2, 0, 4,19, 2, 10000
21, 2, 0, 7,30, 2, 10000
22, 2, 0, 6,30, 2, 10000
10, 2, 0, 5,17, 2, 10000
14, 2, 0, 7,23, 2, 10000
13, 2, 0, 8,23, 2, 10000
8, 2, 0, 1,11, 2, 10000
17, 2, 0, 5,24, 2, 10000
22, 2, 0, 3,27, 2, 10000
15, 2, 0, 4,21, 2, 10000
16, 2, 0, 5,23, 2, 10000
9, 2, 0, 2,13, 2, 10000
12, 2, 0, 5,19, 2, 10000
19, 2, 0, 4,25, 2, 10000
14, 2, 0, 5,21, 2, 10000
17, 2, 0, 3,22, 2, 10000
7, 2, 0, 3,12, 2, 10000
18, 2, 0, 4,24, 2, 10000
18, 2, 0, 4,24, 2, 10000
8, 2, 0, 2,12, 2, 10000
13, 2, 0, 1,16, 2, 10000
20, 2, 0, 10,32, 2, 10000
14, 2, 0, 3,19, 2, 10000
16, 2, 0, 5,23, 2, 10000
12, 2, 0, 7,21, 2, 10000
17, 2, 0, 4,23, 2, 10000
21, 2, 0, 5,28, 2, 10000
15, 2, 0, 7,24, 2, 10000
11, 2, 0, 5,18, 2, 10000
19, 2, 0, 5,26, 2, 10000
11, 2, 0, 4,17, 2, 10000
16, 2, 0, 5,23, 2, 10000
20, 2, 0, 6,28, 2, 10000
13, 2, 0, 6,21, 2, 10000
21, 2, 0, 4,27, 2, 10000
20, 2, 0, 9,31, 2, 10000
9, 2, 0, 5,16, 2, 10000
16, 2, 0, 8,26, 2, 10000
15, 2, 0, 5,22, 2, 10000
17, 2, 0, 2,21, 2, 10000
12, 2, 0, 3,17, 2, 10000
16, 2, 0, 7,25, 2, 10000
12, 2, 0, 4,18, 2, 10000
17, 2, 0, 3,22, 2, 10000
16, 2, 0, 4,22, 2, 10000
17, 2, 0, 5,24, 2, 10000
18, 2, 0, 5,25, 2, 10000
2, 2, 0, 3,7, 2, 10000
17, 2, 0, 2,21, 2, 10000
8, 2, 0, 3,13, 2, 10000
11, 2, 0, 5,18, 2, 10000
12, 2, 0, 4,18, 2, 10000
21, 2, 0, 4,27, 2, 10000
12, 2, 0, 2,16, 2, 10000
20, 2, 0, 5,27, 2, 10000
14, 2, 0, 6,22, 2, 10000
8, 2, 0, 8,18, 2, 10000
18, 2, 0, 4,24, 2, 10000
16, 2, 0, 7,25, 2, 10000
15, 2, 0, 9,26, 2, 10000
17, 2, 0, 4,23, 2, 10000
16, 2, 0, 2,20, 2, 10000
15, 2, 0, 6,23, 2, 10000
11, 2, 0, 3,16, 2, 10000
17, 2, 0, 4,23, 2, 10000
8, 2, 0, 2,12, 2, 10000
18, 2, 0, 6,26, 2, 10000
7, 2, 0, 6,15, 2, 10000
8, 2, 0, 9,19, 2, 10000
17, 2, 0, 3,22, 2, 10000
19, 2, 0, 4,25, 2, 10000
20, 2, 0, 4,26, 2, 10000
16, 2, 0, 2,20, 2, 10000
13, 2, 0, 7,22, 2, 10000
15, 2, 0, 1,18, 2, 10000
20, 2, 0, 3,25, 2, 10000
19, 2, 0, 8,29, 2, 10000
9, 2, 0, 4,15, 2, 10000
14, 2, 0, 3,19, 2, 10000
16, 2, 0, 7,25, 2, 10000
6, 2, 0, 10,18, 2, 10000
12, 2, 0, 3,17, 2, 10000
6, 2, 0, 2,10, 2, 10000
13, 2, 0, 4,19, 2, 10000
24, 2, 0, 6,32, 2, 10000
20, 2, 0, 6,28, 2, 10000
25, 2, 0, 5,32, 2, 10000
17, 2, 0, 6,25, 2, 10000
9, 2, 0, 3,14, 2, 10000
14, 2, 0, 7,23, 2, 10000
20, 2, 0, 2,24, 2, 10000
10, 2, 0, 3,15, 2, 10000
9, 2, 0, 3,14, 2, 10000
9, 2, 0, 6,17, 2, 10000
19, 2, 0, 5,26, 2, 10000
11, 2, 0, 6,19, 2, 10000
10, 2, 0, 6,18, 2, 10000
21, 2, 0, 4,27, 2, 10000
14, 2, 0, 6,22, 2, 10000
13, 2, 0, 5,20, 2, 10000
17, 2, 0, 9,28, 2, 10000
18, 2, 0, 12,32, 2, 10000
16, 2, 0, 2,20, 2, 10000
10, 2, 0, 5,17, 2, 10000
16, 2, 0, 3,21, 2, 10000
10, 2, 0, 3,15, 2, 10000
11, 2, 0, 5,18, 2, 10000
10, 2, 0, 5,17, 2, 10000
16, 2, 0, 7,25, 2, 10000
18, 2, 0, 7,27, 2, 10000
13, 2, 0, 7,22, 2, 10000
13, 2, 0, 4,19, 2, 10000
17, 2, 0, 1,20, 2, 10000
17, 2, 0, 4,23, 2, 10000
16, 2, 0, 3,21, 2, 10000
12, 2, 0, 4,18, 2, 10000
18, 2, 0, 3,23, 2, 10000
12, 2, 0, 2,16, 2, 10000
13, 2, 0, 2,17, 2, 10000
17, 2, 0, 4,23, 2, 10000
11, 2, 0, 9,22, 2, 10000
19, 2, 0, 7,28, 2, 10000
11, 2, 0, 2,15, 2, 10000
15, 2, 0, 3,20, 2, 10000
16, 2, 0, 2,20, 2, 10000
15, 2, 0, 3,20, 2, 10000
9, 2, 0, 5,16, 2, 10000
10, 2, 0, 3,15, 2, 10000
15, 2, 0, 4,21, 2, 10000
12, 2, 0, 3,17, 2, 10000
13, 2, 0, 2,17, 2, 10000
17, 2, 0, 6,25, 2, 10000
10, 2, 0, 4,16, 2, 10000
20, 2, 0, 11,33, 2, 10000
16, 2, 0, 4,22, 2, 10000
13, 2, 0, 6,21, 2, 10000
21, 2, 0, 5,28, 2, 10000
24, 2, 0, 4,30, 2, 10000
10, 2, 0, 6,18, 2, 10000
12, 2, 0, 2,16, 2, 10000
8, 2, 0, 2,12, 2, 10000
9, 2, 0, 5,16, 2, 10000
10, 2, 0, 3,15, 2, 10000
18, 2, 0, 6,26, 2, 10000
8, 2, 0, 0,10, 2, 10000
17, 2, 0, 1,20, 2, 10000
20, 2, 0, 2,24, 2, 10000
18, 2, 0, 4,24, 2, 10000
17, 2, 0, 3,22, 2, 10000
19, 2, 0, 4,25, 2, 10000
10, 2, 0, 4,16, 2, 10000
21, 2, 0, 8,31, 2, 10000
17, 2, 0, 2,21, 2, 10000
16, 2, 0, 3,21, 2, 10000
11, 2, 0, 2,15, 2, 10000
14, 2, 0, 3,19, 2, 10000
8, 2, 0, 3,13, 2, 10000
19, 2, 0, 2,23, 2, 10000
8, 2, 0, 5,15, 2, 10000
12, 2, 0, 6,20, 2, 10000
17, 2, 0, 1,20, 2, 10000
11, 2, 0, 5,18, 2, 10000
14, 2, 0, 3,19, 2, 10000
16, 2, 0, 4,22, 2, 10000
12, 2, 0, 2,16, 2, 10000
10, 2, 0, 5,17, 2, 10000
15, 2, 0, 5,22, 2, 10000
13, 2, 0, 4,19, 2, 10000
12, 2, 0, 5,19, 2, 10000
17, 2, 0, 3,22, 2, 10000
13, 2, 0, 7,22, 2, 10000
22, 2, 0, 2,26, 2, 10000
15, 2, 0, 6,23, 2, 10000
11, 2, 0, 1,14, 2, 10000
12, 2, 0, 1,15, 2, 10000
11, 2, 0, 8,21, 2, 10000
16, 2, 0, 3,21, 2, 10000
8, 2, 0, 4,14, 2, 10000
18, 2, 0, 1,21, 2, 10000
8, 2, 0, 3,13, 2, 10000
15, 2, 0, 3,20, 2, 10000
18, 2, 0, 6,26, 2, 10000
12, 2, 0, 2,16, 2, 10000
10, 2, 0, 6,18, 2, 10000
11, 2, 0, 4,17, 2, 10000
8, 2, 0, 6,16, 2, 10000
13, 2, 0, 6,21, 2, 10000
14, 2, 0, 4,20, 2, 10000
11, 2, 0, 3,16, 2, 10000
12, 2, 0, 2,16, 2, 10000
16, 2, 0, 3,21, 2, 10000
17, 2, 0, 3,22, 2, 10000
15, 2, 0, 8,25, 2, 10000
16, 2, 0, 5,23, 2, 10000
11, 2, 0, 3,16, 2, 10000
13, 2, 0, 5,20, 2, 10000
13, 2, 0, 2,17, 2, 10000
17, 2, 0, 8,27, 2, 10000
13, 2, 0, 3,18, 2, 10000
17, 2, 0, 2,21, 2, 10000
18, 2, 0, 6,26, 2, 10000
20, 2, 0, 6,28, 2, 10000
12, 2, 0, 5,19, 2, 10000
22, 2, 0, 4,28, 2, 10000
11, 2, 0, 10,23, 2, 10000
11, 2, 0, 4,17, 2, 10000
15, 2, 0, 2,19, 2, 10000
18, 2, 0, 3,23, 2, 10000
20, 2, 0, 3,25, 2, 10000
10, 2, 0, 5,17, 2, 10000
10, 2, 0, 5,17, 2, 10000
16, 2, 0, 5,23, 2, 10000
17, 2, 0, 3,22, 2, 10000
19, 2, 0, 3,24, 2, 10000
7, 2, 0, 5,14, 2, 10000
12, 2, 0, 2,16, 2, 10000
10, 2, 0, 2,14, 2, 10000
16, 2, 0, 1,19, 2, 10000
21, 2, 0, 4,27, 2, 10000
15, 2, 0, 6,23, 2, 10000
16, 2, 0, 1,19, 2, 10000
13, 2, 0, 1,16, 2, 10000
17, 2, 0, 4,23, 2, 10000
20, 2, 0, 5,27, 2, 10000
11, 2, 0, 3,16, 2, 10000
14, 2, 0, 7,23, 2, 10000
9, 2, 0, 4,15, 2, 10000
14, 2, 0, 7,23, 2, 10000
16, 2, 0, 4,22, 2, 10000
15, 2, 0, 3,20, 2, 10000
11, 2, 0, 1,14, 2, 10000
13, 2, 0, 7,22, 2, 10000
12, 2, 0, 4,18, 2, 10000
7, 2, 0, 8,17, 2, 10000
13, 2, 0, 2,17, 2, 10000
14, 2, 0, 3,19, 2, 10000
11, 2, 0, 4,17, 2, 10000
12, 2, 0, 5,19, 2, 10000
17, 2, 0, 6,25, 2, 10000
16, 2, 0, 3,21, 2, 10000
9, 2, 0, 3,14, 2, 10000
11, 2, 0, 5,18, 2, 10000
22, 2, 0, 5,29, 2, 10000
21, 2, 0, 3,26, 2, 10000
7, 2, 0, 2,11, 2, 10000
16, 2, 0, 6,24, 2, 10000
10, 2, 0, 5,17, 2, 10000
14, 2, 0, 6,22, 2, 10000
7, 2, 0, 2,11, 2, 10000
16, 2, 0, 5,23, 2, 10000
9, 2, 0, 3,14, 2, 10000
18, 2, 0, 4,24, 2, 10000
8, 2, 0, 5,15, 2, 10000
15, 2, 0, 2,19, 2, 10000
12, 2, 0, 5,19, 2, 10000
15, 2, 0, 7,24, 2, 10000
9, 2, 0, 4,15, 2, 10000
11, 2, 0, 3,16, 2, 10000
12, 2, 0, 6,20, 2, 10000
14, 2, 0, 6,22, 2, 10000
11, 2, 0, 3,16, 2, 10000
8, 2, 0, 2,12, 2, 10000
17, 2, 0, 5,24, 2, 10000
12, 2, 0, 5,19, 2, 10000
18, 2, 0, 5,25, 2, 10000
14, 2, 0, 0,16, 2, 10000
11, 2, 0, 5,18, 2, 10000
8, 2, 0, 2,12, 2, 10000
9, 2, 0, 6,17, 2, 10000
13, 2, 0, 0,15, 2, 10000
8, 2, 0, 3,13, 2, 10000
11, 2, 0, 2,15, 2, 10000
19, 2, 0, 5,26, 2, 10000
11, 2, 0, 3,16, 2, 10000
12, 2, 0, 8,22, 2, 10000
14, 2, 0, 2,18, 2, 10000
19, 2, 0, 7,28, 2, 10000
17, 2, 0, 4,23, 2, 10000
10, 2, 0, 2,14, 2, 10000
9, 2, 0, 2,13, 2, 10000
12, 2, 0, 5,19, 2, 10000
11, 2, 0, 6,19, 2, 10000
10, 2, 0, 4,16, 2, 10000
16, 2, 0, 5,23, 2, 10000
10, 2, 0, 3,15, 2, 10000
18, 2, 0, 2,22, 2, 10000
11, 2, 0, 3,16, 2, 10000
14, 2, 0, 6,22, 2, 10000
17, 2, 0, 8,27, 2, 10000
15, 2, 0, 6,23, 2, 10000
7, 2, 0, 5,14, 2, 10000
12, 2, 0, 5,19, 2, 10000
16, 2, 0, 8,26, 2, 10000
12, 2, 0, 1,15, 2, 10000
10, 2, 0, 8,20, 2, 10000
17, 2, 0, 3,22, 2, 10000
14, 2, 0, 3,19, 2, 10000
19, 2, 0, 7,28, 2, 10000
11, 2, 0, 2,15, 2, 10000
19, 2, 0, 3,24, 2, 10000
14, 2, 0, 5,21, 2, 10000
15, 2, 0, 7,24, 2, 10000
20, 2, 0, 2,24, 2, 10000
20, 2, 0, 1,23, 2, 10000
12, 2, 0, 8,22, 2, 10000
9, 2, 0, 5,16, 2, 10000
16, 2, 0, 2,20, 2, 10000
15, 2, 0, 5,22, 2, 10000
12, 2, 0, 3,17, 2, 10000
19, 2, 0, 6,27, 2, 10000
10, 2, 0, 3,15, 2, 10000
17, 2, 0, 0,19, 2, 10000
23, 2, 0, 3,28, 2, 10000
10, 2, 0, 6,18, 2, 10000
17, 2, 0, 6,25, 2, 10000
21, 2, 0, 4,27, 2, 10000
15, 2, 0, 5,22, 2, 10000
12, 2, 0, 6,20, 2, 10000
22, 2, 0, 2,26, 2, 10000
11, 2, 0, 2,15, 2, 10000
4, 2, 0, 5,11, 2, 10000
11, 2, 0, 4,17, 2, 10000
13, 2, 0, 5,20, 2, 10000
10, 2, 0, 5,17, 2, 10000
10, 2, 0, 9,21, 2, 10000
23, 2, 0, 0,25, 2, 10000
17, 2, 0, 2,21, 2, 10000
12, 2, 0, 5,19, 2, 10000
5, 2, 0, 4,11, 2, 10000
18, 2, 0, 8,28, 2, 10000
9, 2, 0, 6,17, 2, 10000
12, 2, 0, 5,19, 2, 10000
14, 2, 0, 3,19, 2, 10000
17, 2, 0, 5,24, 2, 10000
15, 2, 0, 6,23, 2, 10000
10, 2, 0, 5,17, 2, 10000
17, 2, 0, 6,25, 2, 10000
24, 2, 0, 3,29, 2, 10000
11, 2, 0, 8,21, 2, 10000
11, 2, 0, 5,18, 2, 10000
9, 2, 0, 8,19, 2, 10000
11, 2, 0, 2,15, 2, 10000
21, 2, 0, 2,25, 2, 10000
15, 2, 0, 2,19, 2, 10000
17, 2, 0, 2,21, 2, 10000
13, 2, 0, 5,20, 2, 10000
12, 2, 0, 3,17, 2, 10000
15, 2, 0, 1,18, 2, 10000
20, 2, 0, 1,23, 2, 10000
12, 2, 0, 4,18, 2, 10000
13, 2, 0, 11,26, 2, 10000
16, 2, 0, 4,22, 2, 10000
14, 2, 0, 5,21, 2, 10000
16, 2, 0, 3,21, 2, 10000
12, 2, 0, 3,17, 2, 10000
15, 2, 0, 5,22, 2, 10000
15, 2, 0, 2,19, 2, 10000
16, 2, 0, 2,20, 2, 10000
17, 2, 0, 4,23, 2, 10000
10, 2, 0, 4,16, 2, 10000
14, 2, 0, 6,22, 2, 10000
14, 2, 0, 5,21, 2, 10000
11, 2, 0, 3,16, 2, 10000
18, 2, 0, 10,30, 2, 10000
12, 2, 0, 7,21, 2, 10000
12, 2, 0, 2,16, 2, 10000
10, 2, 0, 4,16, 2, 10000
14, 2, 0, 3,19, 2, 10000
5, 2, 0, 7,14, 2, 10000
7, 2, 0, 3,12, 2, 10000
17, 2, 0, 4,23, 2, 10000
17, 2, 0, 9,28, 2, 10000
6, 2, 0, 1,9, 2, 10000
21, 2, 0, 8,31, 2, 10000
11, 2, 0, 4,17, 2, 10000
12, 2, 0, 6,20, 2, 10000
20, 2, 0, 5,27, 2, 10000
10, 2, 0, 3,15, 2, 10000
13, 2, 0, 4,19, 2, 10000
9, 2, 0, 7,18, 2, 10000
11, 2, 0, 6,19, 2, 10000
12, 2, 0, 1,15, 2, 10000
9, 2, 0, 5,16, 2, 10000
10, 2, 0, 2,14, 2, 10000
15, 2, 0, 3,20, 2, 10000
12, 2, 0, 2,16, 2, 10000
11, 2, 0, 6,19, 2, 10000
18, 2, 0, 2,22, 2, 10000
7, 2, 0, 2,11, 2, 10000
22, 2, 0, 5,29, 2, 10000
14, 2, 0, 6,22, 2, 10000
13, 2, 0, 3,18, 2, 10000
15, 2, 0, 4,21, 2, 10000
10, 2, 0, 5,17, 2, 10000
17, 2, 0, 6,25, 2, 10000
11, 2, 0, 9,22, 2, 10000
12, 2, 0, 3,17, 2, 10000
10, 2, 0, 6,18, 2, 10000
13, 2, 0, 8,23, 2, 10000
15, 2, 0, 7,24, 2, 10000
17, 2, 0, 1,20, 2, 10000
13, 2, 0, 0,15, 2, 10000
9, 2, 0, 3,14, 2, 10000
13, 2, 0, 7,22, 2, 10000
18, 2, 0, 5,25, 2, 10000
17, 2, 0, 3,22, 2, 10000
17, 2, 0, 5,24, 2, 10000
15, 2, 0, 9,26, 2, 10000
13, 2, 0, 8,23, 2, 10000
9, 2, 0, 5,16, 2, 10000
12, 2, 0, 4,18, 2, 10000
10, 2, 0, 11,23, 2, 10000
22, 2, 0, 2,26, 2, 10000
13, 2, 0, 4,19, 2, 10000
16, 2, 0, 5,23, 2, 10000
12, 2, 0, 3,17, 2, 10000
17, 2, 0, 5,24, 2, 10000
15, 2, 0, 2,19, 2, 10000
13, 2, 0, 5,20, 2, 10000
23, 2, 0, 4,29, 2, 10000
25, 2, 0, 1,28, 2, 10000
12, 2, 0, 3,17, 2, 10000
18, 2, 0, 3,23, 2, 10000
12, 2, 0, 3,17, 2, 10000
14, 2, 0, 3,19, 2, 10000
16, 2, 0, 3,21, 2, 10000
9, 2, 0, 4,15, 2, 10000
16, 2, 0, 3,21, 2, 10000
15, 2, 0, 6,23, 2, 10000
13, 2, 0, 2,17, 2, 10000
14, 2, 0, 8,24, 2, 10000
21, 2, 0, 5,28, 2, 10000
11, 2, 0, 3,16, 2, 10000
9, 2, 0, 1,12, 2, 10000
17, 2, 0, 4,23, 2, 10000
13, 2, 0, 6,21, 2, 10000
7, 2, 0, 3,12, 2, 10000
12, 2, 0, 4,18, 2, 10000
14, 2, 0, 6,22, 2, 10000
14, 2, 0, 6,22, 2, 10000
14, 2, 0, 6,22, 2, 10000
17, 2, 0, 3,22, 2, 10000
15, 2, 0, 4,21, 2, 10000
7, 2, 0, 2,11, 2, 10000
7, 2, 0, 3,12, 2, 10000
12, 2, 0, 1,15, 2, 10000
12, 2, 0, 2,16, 2, 10000
12, 2, 0, 6,20, 2, 10000
12, 2, 0, 5,19, 2, 10000
8, 2, 0, 7,17, 2, 10000
9, 2, 0, 4,15, 2, 10000
22, 2, 0, 3,27, 2, 10000
15, 2, 0, 5,22, 2, 10000
10, 2, 0, 6,18, 2, 10000
16, 2, 0, 4,22, 2, 10000
10, 2, 0, 0,12, 2, 10000
12, 2, 0, 1,15, 2, 10000
12, 2, 0, 9,23, 2, 10000
10, 2, 0, 4,16, 2, 10000
12, 2, 0, 6,20, 2, 10000
13, 2, 0, 1,16, 2, 10000
9, 2, 0, 4,15, 2, 10000
11, 2, 0, 3,16, 2, 10000
9, 2, 0, 2,13, 2, 10000
9, 2, 0, 5,16, 2, 10000
18, 2, 0, 5,25, 2, 10000
14, 2, 0, 11,27, 2, 10000
15, 2, 0, 3,20, 2, 10000
13, 2, 0, 2,17, 2, 10000
16, 2, 0, 4,22, 2, 10000
21, 2, 0, 4,27, 2, 10000
18, 2, 0, 2,22, 2, 10000
12, 2, 0, 4,18, 2, 10000
26, 2, 0, 2,30, 2, 10000
10, 2, 0, 7,19, 2, 10000
13, 2, 0, 6,21, 2, 10000
19, 2, 0, 1,22, 2, 10000
7, 2, 0, 6,15, 2, 10000
15, 2, 0, 2,19, 2, 10000
12, 2, 0, 5,19, 2, 10000
20, 2, 0, 2,24, 2, 10000
9, 2, 0, 4,15, 2, 10000
10, 2, 0, 2,14, 2, 10000
19, 2, 0, 5,26, 2, 10000
17, 2, 0, 3,22, 2, 10000
8, 2, 0, 5,15, 2, 10000
9, 2, 0, 6,17, 2, 10000
11, 2, 0, 5,18, 2, 10000
13, 2, 0, 2,17, 2, 10000
14, 2, 0, 1,17, 2, 10000
12, 2, 0, 4,18, 2, 10000
20, 2, 0, 4,26, 2, 10000
6, 2, 0, 5,13, 2, 10000
18, 2, 0, 3,23, 2, 10000
18, 2, 0, 3,23, 2, 10000
11, 2, 0, 5,18, 2, 10000
9, 2, 0, 4,15, 2, 10000
12, 2, 0, 6,20, 2, 10000
11, 2, 0, 3,16, 2, 10000
12, 2, 0, 5,19, 2, 10000
19, 2, 0, 5,26, 2, 10000
16, 2, 0, 4,22, 2, 10000
11, 2, 0, 4,17, 2, 10000
17, 2, 0, 3,22, 2, 10000
16, 2, 0, 5,23, 2, 10000
13, 2, 0, 5,20, 2, 10000
10, 2, 0, 4,16, 2, 10000
20, 2, 0, 3,25, 2, 10000
15, 2, 0, 3,20, 2, 10000
14, 2, 0, 3,19, 2, 10000
19, 2, 0, 9,30, 2, 10000
8, 2, 0, 3,13, 2, 10000
12, 2, 0, 2,16, 2, 10000
15, 2, 0, 4,21, 2, 10000
17, 2, 0, 0,19, 2, 10000
15, 2, 0, 4,21, 2, 10000
10, 2, 0, 3,15, 2, 10000
11, 2, 0, 2,15, 2, 10000
17, 2, 0, 6,25, 2, 10000
19, 2, 0, 8,29, 2, 10000
7, 2, 0, 3,12, 2, 10000
12, 2, 0, 3,17, 2, 10000
10, 2, 0, 2,14, 2, 10000
10, 2, 0, 5,17, 2, 10000
20, 2, 0, 5,27, 2, 10000
15, 2, 0, 2,19, 2, 10000
9, 2, 0, 3,14, 2, 10000
12, 2, 0, 7,21, 2, 10000
6, 2, 0, 3,11, 2, 10000
10, 2, 0, 1,13, 2, 10000
20, 2, 0, 6,28, 2, 10000
8, 2, 0, 7,17, 2, 10000
17, 2, 0, 1,20, 2, 10000
19, 2, 0, 2,23, 2, 10000
15, 2, 0, 3,20, 2, 10000
11, 2, 0, 3,16, 2, 10000
20, 2, 0, 4,26, 2, 10000
12, 2, 0, 5,19, 2, 10000
8, 2, 0, 3,13, 2, 10000
10, 2, 0, 4,16, 2, 10000
12, 2, 0, 4,18, 2, 10000
17, 2, 0, 6,25, 2, 10000
15, 2, 0, 8,25, 2, 10000
14, 2, 0, 2,18, 2, 10000
13, 2, 0, 3,18, 2, 10000
19, 2, 0, 4,25, 2, 10000
8, 2, 0, 4,14, 2, 10000
6, 2, 0, 8,16, 2, 10000
7, 2, 0, 5,14, 2, 10000
13, 2, 0, 0,15, 2, 10000
12, 2, 0, 4,18, 2, 10000
14, 2, 0, 5,21, 2, 10000
11, 2, 0, 3,16, 2, 10000
15, 2, 0, 4,21, 2, 10000
11, 2, 0, 4,17, 2, 10000
13, 2, 0, 4,19, 2, 10000
9, 2, 0, 2,13, 2, 10000
16, 2, 0, 4,22, 2, 10000
22, 2, 0, 2,26, 2, 10000
9, 2, 0, 2,13, 2, 10000
7, 2, 0, 5,14, 2, 10000
12, 2, 0, 2,16, 2, 10000
17, 2, 0, 3,22, 2, 10000
15, 2, 0, 4,21, 2, 10000
11, 2, 0, 4,17, 2, 10000
12, 2, 0, 5,19, 2, 10000
20, 2, 0, 8,30, 2, 10000
17, 2, 0, 5,24, 2, 10000
9, 2, 0, 3,14, 2, 10000
14, 2, 0, 2,18, 2, 10000
16, 2, 0, 7,25, 2, 10000
10, 2, 0, 6,18, 2, 10000
10, 2, 0, 6,18, 2, 10000
14, 2, 0, 1,17, 2, 10000
20, 2, 0, 1,23, 2, 10000
13, 2, 0, 6,21, 2, 10000
18, 2, 0, 4,24, 2, 10000
12, 2, 0, 2,16, 2, 10000
14, 2, 0, 6,22, 2, 10000
12, 2, 0, 2,16, 2, 10000
14, 2, 0, 2,18, 2, 10000
11, 2, 0, 7,20, 2, 10000
11, 2, 0, 2,15, 2, 10000
9, 2, 0, 3,14, 2, 10000
9, 2, 0, 6,17, 2, 10000
13, 2, 0, 8,23, 2, 10000
13, 2, 0, 7,22, 2, 10000
11, 2, 0, 5,18, 2, 10000
13, 2, 0, 0,15, 2, 10000
20, 2, 0, 5,27, 2, 10000
14, 2, 0, 7,23, 2, 10000
17, 2, 0, 4,23, 2, 10000
11, 2, 0, 3,16, 2, 10000
8, 2, 0, 0,10, 2, 10000
8, 2, 0, 6,16, 2, 10000
16, 2, 0, 4,22, 2, 10000
16, 2, 0, 2,20, 2, 10000
16, 2, 0, 5,23, 2, 10000
8, 2, 0, 3,13, 2, 10000
14, 2, 0, 5,21, 2, 10000
15, 2, 0, 3,20, 2, 10000
13, 2, 0, 7,22, 2, 10000
17, 2, 0, 4,23, 2, 10000
10, 2, 0, 3,15, 2, 10000
15, 2, 0, 4,21, 2, 10000
9, 2, 0, 2,13, 2, 10000
5, 2, 0, 4,11, 2, 10000
7, 2, 0, 2,11, 2, 10000
6, 2, 0, 5,13, 2, 10000
11, 2, 0, 4,17, 2, 10000
16, 2, 0, 2,20, 2, 10000
13, 2, 0, 4,19, 2, 10000
17, 2, 0, 2,21, 2, 10000
14, 2, 0, 3,19, 2, 10000
14, 2, 0, 7,23, 2, 10000
13, 2, 0, 6,21, 2, 10000
5, 2, 0, 7,14, 2, 10000
11, 2, 0, 3,16, 2, 10000
14, 2, 0, 3,19, 2, 10000
5, 2, 0, 6,13, 2, 10000
24, 2, 0, 2,28, 2, 10000
12, 2, 0, 5,19, 2, 10000
9, 2, 0, 9,20, 2, 10000
11, 2, 0, 3,16, 2, 10000
17, 2, 0, 4,23, 2, 10000
12, 2, 0, 4,18, 2, 10000
16, 2, 0, 4,22, 2, 10000
14, 2, 0, 3,19, 2, 10000
17, 2, 0, 4,23, 2, 10000
12, 2, 0, 5,19, 2, 10000
6, 2, 0, 2,10, 2, 10000
18, 2, 0, 4,24, 2, 10000
11, 2, 0, 5,18, 2, 10000
8, 2, 0, 2,12, 2, 10000
21, 2, 0, 5,28, 2, 10000
7, 2, 0, 9,18, 2, 10000
12, 2, 0, 1,15, 2, 10000
18, 2, 0, 2,22, 2, 10000
18, 2, 0, 4,24, 2, 10000
15, 2, 0, 5,22, 2, 10000
8, 2, 0, 3,13, 2, 10000
11, 2, 0, 7,20, 2, 10000
17, 2, 0, 1,20, 2, 10000
6, 2, 0, 3,11, 2, 10000
12, 2, 0, 4,18, 2, 10000
10, 2, 0, 4,16, 2, 10000
9, 2, 0, 3,14, 2, 10000
15, 2, 0, 7,24, 2, 10000
8, 2, 0, 2,12, 2, 10000
5, 2, 0, 4,11, 2, 10000
10, 2, 0, 3,15, 2, 10000
10, 2, 0, 5,17, 2, 10000
3, 2, 0, 2,7, 2, 10000
12, 2, 0, 6,20, 2, 10000
14, 2, 0, 7,23, 2, 10000
7, 2, 0, 5,14, 2, 10000
10, 2, 0, 5,17, 2, 10000
15, 2, 0, 4,21, 2, 10000
17, 2, 0, 4,23, 2, 10000
12, 2, 0, 3,17, 2, 10000
21, 2, 0, 4,27, 2, 10000
10, 2, 0, 8,20, 2, 10000
11, 2, 0, 3,16, 2, 10000
13, 2, 0, 4,19, 2, 10000
13, 2, 0, 1,16, 2, 10000
11, 2, 0, 6,19, 2, 10000
11, 2, 0, 2,15, 2, 10000
12, 2, 0, 0,14, 2, 10000
11, 2, 0, 2,15, 2, 10000
10, 2, 0, 1,13, 2, 10000
10, 2, 0, 8,20, 2, 10000
13, 2, 0, 1,16, 2, 10000
10, 2, 0, 2,14, 2, 10000
16, 2, 0, 4,22, 2, 10000
10, 2, 0, 3,15, 2, 10000
14, 2, 0, 3,19, 2, 10000
16, 2, 0, 9,27, 2, 10000
9, 2, 0, 8,19, 2, 10000
16, 2, 0, 3,21, 2, 10000
14, 2, 0, 2,18, 2, 10000
20, 2, 0, 5,27, 2, 10000
8, 2, 0, 4,14, 2, 10000
16, 2, 0, 3,21, 2, 10000
5, 2, 0, 4,11, 2, 10000
15, 2, 0, 1,18, 2, 10000
11, 2, 0, 4,17, 2, 10000
16, 2, 0, 1,19, 2, 10000
10, 2, 0, 6,18, 2, 10000
14, 2, 0, 5,21, 2, 10000
10, 2, 0, 3,15, 2, 10000
7, 2, 0, 6,15, 2, 10000
10, 2, 0, 8,20, 2, 10000
9, 2, 0, 3,14, 2, 10000
21, 2, 0, 5,28, 2, 10000
14, 2, 0, 4,20, 2, 10000
8, 2, 0, 4,14, 2, 10000
3, 2, 0, 4,9, 2, 10000
10, 2, 0, 7,19, 2, 10000
4, 2, 0, 4,10, 2, 10000
15, 2, 0, 2,19, 2, 10000
11, 2, 0, 4,17, 2, 10000
10, 2, 0, 7,19, 2, 10000
7, 2, 0, 5,14, 2, 10000
15, 2, 0, 8,25, 2, 10000
13, 2, 0, 1,16, 2, 10000
12, 2, 0, 1,15, 2, 10000
17, 2, 0, 2,21, 2, 10000
18, 2, 0, 7,27, 2, 10000
10, 2, 0, 2,14, 2, 10000
11, 2, 0, 4,17, 2, 10000
14, 2, 0, 5,21, 2, 10000
13, 2, 0, 5,20, 2, 10000
14, 2, 0, 2,18, 2, 10000
16, 2, 0, 2,20, 2, 10000
18, 2, 0, 6,26, 2, 10000
12, 2, 0, 2,16, 2, 10000
13, 2, 0, 3,18, 2, 10000
14, 2, 0, 3,19, 2, 10000
13, 2, 0, 3,18, 2, 10000
19, 2, 0, 7,28, 2, 10000
12, 2, 0, 3,17, 2, 10000
8, 2, 0, 5,15, 2, 10000
17, 2, 0, 2,21, 2, 10000
10, 2, 0, 5,17, 2, 10000
9, 2, 0, 6,17, 2, 10000
14, 2, 0, 6,22, 2, 10000
12, 2, 0, 3,17, 2, 10000
8, 2, 0, 2,12, 2, 10000
17, 2, 0, 5,24, 2, 10000
12, 2, 0, 4,18, 2, 10000
14, 2, 0, 3,19, 2, 10000
6, 2, 0, 4,12, 2, 10000
20, 2, 0, 4,26, 2, 10000
15, 2, 0, 2,19, 2, 10000
13, 2, 0, 5,20, 2, 10000
5, 2, 0, 6,13, 2, 10000
12, 2, 0, 4,18, 2, 10000
14, 2, 0, 4,20, 2, 10000
11, 2, 0, 1,14, 2, 10000
10, 2, 0, 4,16, 2, 10000
11, 2, 0, 4,17, 2, 10000
11, 2, 0, 1,14, 2, 10000
8, 2, 0, 2,12, 2, 10000
17, 2, 0, 5,24, 2, 10000
10, 2, 0, 4,16, 2, 10000
13, 2, 0, 6,21, 2, 10000
14, 2, 0, 3,19, 2, 10000
13, 2, 0, 1,16, 2, 10000
7, 2, 0, 5,14, 2, 10000
13, 2, 0, 3,18, 2, 10000
20, 2, 0, 4,26, 2, 10000
14, 2, 0, 3,19, 2, 10000
17, 2, 0, 8,27, 2, 10000
6, 2, 0, 5,13, 2, 10000
14, 2, 0, 6,22, 2, 10000
13, 2, 0, 3,18, 2, 10000
10, 2, 0, 2,14, 2, 10000
17, 2, 0, 4,23, 2, 10000
12, 2, 0, 2,16, 2, 10000
15, 2, 0, 4,21, 2, 10000
15, 2, 0, 4,21, 2, 10000
14, 2, 0, 4,20, 2, 10000
10, 2, 0, 6,18, 2, 10000
17, 2, 0, 4,23, 2, 10000
6, 2, 0, 5,13, 2, 10000
9, 2, 0, 2,13, 2, 10000
14, 2, 0, 3,19, 2, 10000
8, 2, 0, 4,14, 2, 10000
10, 2, 0, 5,17, 2, 10000
11, 2, 0, 6,19, 2, 10000
15, 2, 0, 1,18, 2, 10000
14, 2, 0, 4,20, 2, 10000
13, 2, 0, 1,16, 2, 10000
17, 2, 0, 3,22, 2, 10000
7, 2, 0, 2,11, 2, 10000
9, 2, 0, 5,16, 2, 10000
15, 2, 0, 1,18, 2, 10000
7, 2, 0, 3,12, 2, 10000
12, 2, 0, 1,15, 2, 10000
13, 2, 0, 7,22, 2, 10000
11, 2, 0, 3,16, 2, 10000
11, 2, 0, 3,16, 2, 10000
11, 2, 0, 7,20, 2, 10000
13, 2, 0, 3,18, 2, 10000
15, 2, 0, 3,20, 2, 10000
10, 2, 0, 4,16, 2, 10000
15, 2, 0, 3,20, 2, 10000
16, 2, 0, 7,25, 2, 10000
6, 2, 0, 4,12, 2, 10000
13, 2, 0, 8,23, 2, 10000
15, 2, 0, 5,22, 2, 10000
14, 2, 0, 2,18, 2, 10000
14, 2, 0, 4,20, 2, 10000
15, 2, 0, 5,22, 2, 10000
6, 2, 0, 5,13, 2, 10000
14, 2, 0, 4,20, 2, 10000
14, 2, 0, 1,17, 2, 10000
12, 2, 0, 6,20, 2, 10000
5, 2, 0, 3,10, 2, 10000
14, 2, 0, 3,19, 2, 10000
16, 2, 0, 4,22, 2, 10000
9, 2, 0, 4,15, 2, 10000
7, 2, 0, 2,11, 2, 10000
11, 2, 0, 2,15, 2, 10000
9, 2, 0, 3,14, 2, 10000
7, 2, 0, 2,11, 2, 10000
9, 2, 0, 5,16, 2, 10000
10, 2, 0, 4,16, 2, 10000
9, 2, 0, 4,15, 2, 10000
7, 2, 0, 3,12, 2, 10000
11, 2, 0, 1,14, 2, 10000
9, 2, 0, 6,17, 2, 10000
11, 2, 0, 9,22, 2, 10000
15, 2, 0, 4,21, 2, 10000
18, 2, 0, 4,24, 2, 10000
14, 2, 0, 1,17, 2, 10000
7, 2, 0, 4,13, 2, 10000
14, 2, 0, 6,22, 2, 10000
21, 2, 0, 3,26, 2, 10000
13, 2, 0, 5,20, 2, 10000
10, 2, 0, 2,14, 2, 10000
10, 2, 0, 5,17, 2, 10000
17, 2, 0, 2,21, 2, 10000
7, 2, 0, 8,17, 2, 10000
8, 2, 0, 3,13, 2, 10000
11, 2, 0, 4,17, 2, 10000
15, 2, 0, 3,20, 2, 10000
10, 2, 0, 3,15, 2, 10000
7, 2, 0, 4,13, 2, 10000
11, 2, 0, 1,14, 2, 10000
16, 2, 0, 3,21, 2, 10000
13, 2, 0, 5,20, 2, 10000
10, 2, 0, 5,17, 2, 10000
17, 2, 0, 11,30, 2, 10000
10, 2, 0, 1,13, 2, 10000
6, 2, 0, 0,8, 2, 10000
14, 2, 0, 3,19, 2, 10000
15, 2, 0, 5,22, 2, 10000
10, 2, 0, 3,15, 2, 10000
15, 2, 0, 6,23, 2, 10000
7, 2, 0, 2,11, 2, 10000
14, 2, 0, 4,20, 2, 10000
5, 2, 0, 7,14, 2, 10000
13, 2, 0, 3,18, 2, 10000
16, 2, 0, 3,21, 2, 10000
8, 2, 0, 4,14, 2, 10000
10, 2, 0, 5,17, 2, 10000
20, 2, 0, 5,27, 2, 10000
14, 2, 0, 3,19, 2, 10000
10, 2, 0, 2,14, 2, 10000
11, 2, 0, 3,16, 2, 10000
10, 2, 0, 1,13, 2, 10000
12, 2, 0, 4,18, 2, 10000
12, 2, 0, 3,17, 2, 10000
4, 2, 0, 5,11, 2, 10000
9, 2, 0, 3,14, 2, 10000
15, 2, 0, 2,19, 2, 10000
16, 2, 0, 2,20, 2, 10000
19, 2, 0, 1,22, 2, 10000
8, 2, 0, 3,13, 2, 10000
14, 2, 0, 3,19, 2, 10000
11, 2, 0, 5,18, 2, 10000
13, 2, 0, 2,17, 2, 10000
14, 2, 0, 3,19, 2, 10000
13, 2, 0, 8,23, 2, 10000
9, 2, 0, 4,15, 2, 10000
10, 2, 0, 3,15, 2, 10000
11, 2, 0, 3,16, 2, 10000
12, 2, 0, 5,19, 2, 10000
11, 2, 0, 3,16, 2, 10000
15, 2, 0, 4,21, 2, 10000
14, 2, 0, 3,19, 2, 10000
11, 2, 0, 4,17, 2, 10000
10, 2, 0, 3,15, 2, 10000
13, 2, 0, 4,19, 2, 10000
3, 2, 0, 2,7, 2, 10000
10, 2, 0, 2,14, 2, 10000
7, 2, 0, 3,12, 2, 10000
19, 2, 0, 1,22, 2, 10000
7, 2, 0, 2,11, 2, 10000
11, 2, 0, 3,16, 2, 10000
10, 2, 0, 2,14, 2, 10000
7, 2, 0, 3,12, 2, 10000
6, 2, 0, 5,13, 2, 10000
7, 2, 0, 5,14, 2, 10000
13, 2, 0, 4,19, 2, 10000
10, 2, 0, 4,16, 2, 10000
7, 2, 0, 8,17, 2, 10000
10, 2, 0, 4,16, 2, 10000
10, 2, 0, 2,14, 2, 10000
11, 2, 0, 4,17, 2, 10000
11, 2, 0, 6,19, 2, 10000
16, 2, 0, 0,18, 2, 10000
17, 2, 0, 3,22, 2, 10000
14, 2, 0, 6,22, 2, 10000
20, 2, 0, 1,23, 2, 10000
10, 2, 0, 5,17, 2, 10000
11, 2, 0, 3,16, 2, 10000
9, 2, 0, 4,15, 2, 10000
13, 2, 0, 5,20, 2, 10000
12, 2, 0, 5,19, 2, 10000
14, 2, 0, 3,19, 2, 10000
14, 2, 0, 3,19, 2, 10000
18, 2, 0, 3,23, 2, 10000
11, 2, 0, 4,17, 2, 10000
15, 2, 0, 5,22, 2, 10000
8, 2, 0, 6,16, 2, 10000
11, 2, 0, 5,18, 2, 10000
7, 2, 0, 1,10, 2, 10000
12, 2, 0, 3,17, 2, 10000
11, 2, 0, 5,18, 2, 10000
5, 2, 0, 2,9, 2, 10000
16, 2, 0, 2,20, 2, 10000
9, 2, 0, 1,12, 2, 10000
11, 2, 0, 3,16, 2, 10000
13, 2, 0, 5,20, 2, 10000
15, 2, 0, 4,21, 2, 10000
16, 2, 0, 3,21, 2, 10000
14, 2, 0, 1,17, 2, 10000
15, 2, 0, 4,21, 2, 10000
19, 2, 0, 6,27, 2, 10000
12, 2, 0, 2,16, 2, 10000
8, 2, 0, 6,16, 2, 10000
11, 2, 0, 7,20, 2, 10000
8, 2, 0, 6,16, 2, 10000
8, 2, 0, 0,10, 2, 10000
18, 2, 0, 7,27, 2, 10000
13, 2, 0, 2,17, 2, 10000
6, 2, 0, 3,11, 2, 10000
18, 2, 0, 6,26, 2, 10000
4, 2, 0, 4,10, 2, 10000
19, 2, 0, 4,25, 2, 10000
16, 2, 0, 3,21, 2, 10000
19, 2, 0, 6,27, 2, 10000
12, 2, 0, 5,19, 2, 10000
10, 2, 0, 3,15, 2, 10000
11, 2, 0, 2,15, 2, 10000
12, 2, 0, 5,19, 2, 10000
14, 2, 0, 8,24, 2, 10000
15, 2, 0, 3,20, 2, 10000
14, 2, 0, 1,17, 2, 10000
11, 2, 0, 4,17, 2, 10000
15, 2, 0, 5,22, 2, 10000
14, 2, 0, 3,19, 2, 10000
8, 2, 0, 1,11, 2, 10000
7, 2, 0, 4,13, 2, 10000
8, 2, 0, 3,13, 2, 10000
18, 2, 0, 2,22, 2, 10000
18, 2, 0, 6,26, 2, 10000
11, 2, 0, 8,21, 2, 10000
13, 2, 0, 6,21, 2, 10000
14, 2, 0, 5,21, 2, 10000
7, 2, 0, 5,14, 2, 10000
8, 2, 0, 1,11, 2, 10000
8, 2, 0, 2,12, 2, 10000
13, 2, 0, 5,20, 2, 10000
9, 2, 0, 2,13, 2, 10000
17, 2, 0, 9,28, 2, 10000
17, 2, 0, 4,23, 2, 10000
7, 2, 0, 3,12, 2, 10000
10, 2, 0, 3,15, 2, 10000
11, 2, 0, 2,15, 2, 10000
15, 2, 0, 7,24, 2, 10000
10, 2, 0, 7,19, 2, 10000
10, 2, 0, 3,15, 2, 10000
10, 2, 0, 4,16, 2, 10000
14, 2, 0, 5,21, 2, 10000
13, 2, 0, 3,18, 2, 10000
12, 2, 0, 2,16, 2, 10000
11, 2, 0, 6,19, 2, 10000
10, 2, 0, 2,14, 2, 10000
10, 2, 0, 2,14, 2, 10000
8, 2, 0, 3,13, 2, 10000
9, 2, 0, 4,15, 2, 10000
5, 2, 0, 2,9, 2, 10000
12, 2, 0, 3,17, 2, 10000
22, 2, 0, 2,26, 2, 10000
9, 2, 0, 7,18, 2, 10000
7, 2, 0, 2,11, 2, 10000
13, 2, 0, 2,17, 2, 10000
10, 2, 0, 1,13, 2, 10000
13, 2, 0, 2,17, 2, 10000
13, 2, 0, 4,19, 2, 10000
8, 2, 0, 1,11, 2, 10000
11, 2, 0, 4,17, 2, 10000
14, 2, 0, 5,21, 2, 10000
12, 2, 0, 2,16, 2, 10000
15, 2, 0, 3,20, 2, 10000
11, 2, 0, 6,19, 2, 10000
12, 2, 0, 8,22, 2, 10000
15, 2, 0, 3,20, 2, 10000
8, 2, 0, 3,13, 2, 10000
12, 2, 0, 3,17, 2, 10000
6, 2, 0, 3,11, 2, 10000
11, 2, 0, 1,14, 2, 10000
9, 2, 0, 4,15, 2, 10000
16, 2, 0, 2,20, 2, 10000
10, 2, 0, 5,17, 2, 10000
12, 2, 0, 5,19, 2, 10000
6, 2, 0, 1,9, 2, 10000
12, 2, 0, 2,16, 2, 10000
11, 2, 0, 6,19, 2, 10000
15, 2, 0, 2,19, 2, 10000
15, 2, 0, 1,18, 2, 10000
22, 2, 0, 2,26, 2, 10000
6, 2, 0, 1,9, 2, 10000
13, 2, 0, 5,20, 2, 10000
5, 2, 0, 3,10, 2, 10000
15, 2, 0, 2,19, 2, 10000
18, 2, 0, 5,25, 2, 10000
13, 2, 0, 4,19, 2, 10000
17, 2, 0, 5,24, 2, 10000
19, 2, 0, 1,22, 2, 10000
17, 2, 0, 7,26, 2, 10000
14, 2, 0, 2,18, 2, 10000
10, 2, 0, 4,16, 2, 10000
9, 2, 0, 5,16, 2, 10000
8, 2, 0, 6,16, 2, 10000
11, 2, 0, 6,19, 2, 10000
10, 2, 0, 2,14, 2, 10000
10, 2, 0, 1,13, 2, 10000
14, 2, 0, 2,18, 2, 10000
7, 2, 0, 1,10, 2, 10000
17, 2, 0, 3,22, 2, 10000
14, 2, 0, 5,21, 2, 10000
13, 2, 0, 5,20, 2, 10000
12, 2, 0, 7,21, 2, 10000
20, 2, 0, 6,28, 2, 10000
8, 2, 0, 2,12, 2, 10000
12, 2, 0, 3,17, 2, 10000
11, 2, 0, 4,17, 2, 10000
13, 2, 0, 3,18, 2, 10000
6, 2, 0, 6,14, 2, 10000
9, 2, 0, 4,15, 2, 10000
16, 2, 0, 4,22, 2, 10000
19, 2, 0, 3,24, 2, 10000
9, 2, 0, 1,12, 2, 10000
12, 2, 0, 3,17, 2, 10000
7, 2, 0, 3,12, 2, 10000
7, 2, 0, 9,18, 2, 10000
9, 2, 0, 5,16, 2, 10000
17, 2, 0, 4,23, 2, 10000
10, 2, 0, 4,16, 2, 10000
17, 2, 0, 2,21, 2, 10000
8, 2, 0, 2,12, 2, 10000
13, 2, 0, 3,18, 2, 10000
14, 2, 0, 4,20, 2, 10000
4, 2, 0, 4,10, 2, 10000
7, 2, 0, 6,15, 2, 10000
8, 2, 0, 6,16, 2, 10000
5, 2, 0, 3,10, 2, 10000
13, 2, 0, 1,16, 2, 10000
6, 2, 0, 6,14, 2, 10000
19, 2, 0, 8,29, 2, 10000
7, 2, 0, 2,11, 2, 10000
10, 2, 0, 2,14, 2, 10000
13, 2, 0, 3,18, 2, 10000
17, 2, 0, 2,21, 2, 10000
11, 2, 0, 6,19, 2, 10000
8, 2, 0, 4,14, 2, 10000
8, 2, 0, 2,12, 2, 10000
21, 2, 0, 4,27, 2, 10000
12, 2, 0, 2,16, 2, 10000
10, 2, 0, 8,20, 2, 10000
13, 2, 0, 5,20, 2, 10000
9, 2, 0, 3,14, 2, 10000
12, 2, 0, 2,16, 2, 10000
13, 2, 0, 2,17, 2, 10000
8, 2, 0, 1,11, 2, 10000
11, 2, 0, 2,15, 2, 10000
13, 2, 0, 3,18, 2, 10000
12, 2, 0, 1,15, 2, 10000
6, 2, 0, 5,13, 2, 10000
17, 2, 0, 12,31, 2, 10000
8, 2, 0, 5,15, 2, 10000
6, 2, 0, 1,9, 2, 10000
10, 2, 0, 5,17, 2, 10000
10, 2, 0, 5,17, 2, 10000
9, 2, 0, 4,15, 2, 10000
7, 2, 0, 3,12, 2, 10000
15, 2, 0, 6,23, 2, 10000
12, 2, 0, 4,18, 2, 10000
8, 2, 0, 2,12, 2, 10000
6, 2, 0, 1,9, 2, 10000
8, 2, 0, 1,11, 2, 10000
9, 2, 0, 4,15, 2, 10000
17, 2, 0, 2,21, 2, 10000
13, 2, 0, 4,19, 2, 10000
13, 2, 0, 3,18, 2, 10000
12, 2, 0, 3,17, 2, 10000
11, 2, 0, 3,16, 2, 10000
17, 2, 0, 2,21, 2, 10000
11, 2, 0, 6,19, 2, 10000
8, 2, 0, 3,13, 2, 10000
15, 2, 0, 6,23, 2, 10000
15, 2, 0, 6,23, 2, 10000
7, 2, 0, 4,13, 2, 10000
14, 2, 0, 5,21, 2, 10000
10, 2, 0, 1,13, 2, 10000
13, 2, 0, 6,21, 2, 10000
18, 2, 0, 5,25, 2, 10000
13, 2, 0, 6,21, 2, 10000
14, 2, 0, 4,20, 2, 10000
17, 2, 0, 3,22, 2, 10000
5, 2, 0, 1,8, 2, 10000
11, 2, 0, 2,15, 2, 10000
11, 2, 0, 7,20, 2, 10000
16, 2, 0, 3,21, 2, 10000
8, 2, 0, 1,11, 2, 10000
9, 2, 0, 4,15, 2, 10000
10, 2, 0, 3,15, 2, 10000
12, 2, 0, 2,16, 2, 10000
10, 2, 0, 3,15, 2, 10000
13, 2, 0, 6,21, 2, 10000
21, 2, 0, 1,24, 2, 10000
17, 2, 0, 6,25, 2, 10000
16, 2, 0, 4,22, 2, 10000
11, 2, 0, 3,16, 2, 10000
7, 2, 0, 8,17, 2, 10000
15, 2, 0, 4,21, 2, 10000
14, 2, 0, 3,19, 2, 10000
9, 2, 0, 1,12, 2, 10000
8, 2, 0, 2,12, 2, 10000
11, 2, 0, 4,17, 2, 10000
10, 2, 0, 2,14, 2, 10000
16, 2, 0, 1,19, 2, 10000
8, 2, 0, 2,12, 2, 10000
14, 2, 0, 3,19, 2, 10000
16, 2, 0, 5,23, 2, 10000
12, 2, 0, 4,18, 2, 10000
15, 2, 0, 4,21, 2, 10000
12, 2, 0, 1,15, 2, 10000
11, 2, 0, 4,17, 2, 10000
19, 2, 0, 7,28, 2, 10000
13, 2, 0, 4,19, 2, 10000
6, 2, 0, 5,13, 2, 10000
16, 2, 0, 3,21, 2, 10000
9, 2, 0, 2,13, 2, 10000
10, 2, 0, 4,16, 2, 10000
12, 2, 0, 8,22, 2, 10000
17, 2, 0, 6,25, 2, 10000
15, 2, 0, 3,20, 2, 10000
16, 2, 0, 5,23, 2, 10000
9, 2, 0, 8,19, 2, 10000
6, 2, 0, 3,11, 2, 10000
14, 2, 0, 5,21, 2, 10000
10, 2, 0, 6,18, 2, 10000
11, 2, 0, 7,20, 2, 10000
19, 2, 0, 3,24, 2, 10000
5, 2, 0, 1,8, 2, 10000
17, 2, 0, 1,20, 2, 10000
19, 2, 0, 1,22, 2, 10000
5, 2, 0, 3,10, 2, 10000
14, 2, 0, 3,19, 2, 10000
6, 2, 0, 3,11, 2, 10000
12, 2, 0, 6,20, 2, 10000
10, 2, 0, 3,15, 2, 10000
13, 2, 0, 1,16, 2, 10000
12, 2, 0, 6,20, 2, 10000
8, 2, 0, 2,12, 2, 10000
10, 2, 0, 4,16, 2, 10000
12, 2, 0, 6,20, 2, 10000
13, 2, 0, 5,20, 2, 10000
11, 2, 0, 2,15, 2, 10000
14, 2, 0, 6,22, 2, 10000
14, 2, 0, 2,18, 2, 10000
9, 2, 0, 4,15, 2, 10000
13, 2, 0, 2,17, 2, 10000
14, 2, 0, 6,22, 2, 10000
12, 2, 0, 6,20, 2, 10000
14, 2, 0, 4,20, 2, 10000
8, 2, 0, 0,10, 2, 10000
11, 2, 0, 3,16, 2, 10000
13, 2, 0, 5,20, 2, 10000
8, 2, 0, 3,13, 2, 10000
15, 2, 0, 3,20, 2, 10000
6, 2, 0, 9,17, 2, 10000
12, 2, 0, 2,16, 2, 10000
8, 2, 0, 7,17, 2, 10000
14, 2, 0, 8,24, 2, 10000
15, 2, 0, 7,24, 2, 10000
5, 2, 0, 4,11, 2, 10000
12, 2, 0, 3,17, 2, 10000
11, 2, 0, 5,18, 2, 10000
11, 2, 0, 4,17, 2, 10000
15, 2, 0, 6,23, 2, 10000
11, 2, 0, 2,15, 2, 10000
8, 2, 0, 8,18, 2, 10000
10, 2, 0, 3,15, 2, 10000
7, 2, 0, 2,11, 2, 10000
11, 2, 0, 3,16, 2, 10000
9, 2, 0, 3,14, 2, 10000
11, 2, 0, 7,20, 2, 10000
11, 2, 0, 3,16, 2, 10000
7, 2, 0, 3,12, 2, 10000
12, 2, 0, 2,16, 2, 10000
10, 2, 0, 3,15, 2, 10000
8, 2, 0, 7,17, 2, 10000
5, 2, 0, 3,10, 2, 10000
12, 2, 0, 4,18, 2, 10000
13, 2, 0, 2,17, 2, 10000
6, 2, 0, 3,11, 2, 10000
8, 2, 0, 1,11, 2, 10000
10, 2, 0, 3,15, 2, 10000
14, 2, 0, 10,26, 2, 10000
7, 2, 0, 5,14, 2, 10000
14, 2, 0, 4,20, 2, 10000
9, 2, 0, 3,14, 2, 10000
7, 2, 0, 1,10, 2, 10000
13, 2, 0, 3,18, 2, 10000
14, 2, 0, 2,18, 2, 10000
9, 2, 0, 2,13, 2, 10000
6, 2, 0, 4,12, 2, 10000
13, 2, 0, 7,22, 2, 10000
12, 2, 0, 5,19, 2, 10000
8, 2, 0, 3,13, 2, 10000
13, 2, 0, 3,18, 2, 10000
14, 2, 0, 5,21, 2, 10000
8, 2, 0, 6,16, 2, 10000
11, 2, 0, 6,19, 2, 10000
7, 2, 0, 4,13, 2, 10000
13, 2, 0, 5,20, 2, 10000
14, 2, 0, 4,20, 2, 10000
18, 2, 0, 5,25, 2, 10000
6, 2, 0, 7,15, 2, 10000
11, 2, 0, 3,16, 2, 10000
14, 2, 0, 3,19, 2, 10000
17, 2, 0, 10,29, 2, 10000
5, 2, 0, 3,10, 2, 10000
13, 2, 0, 3,18, 2, 10000
9, 2, 0, 3,14, 2, 10000
12, 2, 0, 3,17, 2, 10000
4, 2, 0, 7,13, 2, 10000
4, 2, 0, 1,7, 2, 10000
11, 2, 0, 8,21, 2, 10000
9, 2, 0, 2,13, 2, 10000
7, 2, 0, 6,15, 2, 10000
11, 2, 0, 3,16, 2, 10000
12, 2, 0, 8,22, 2, 10000
13, 2, 0, 1,16, 2, 10000
13, 2, 0, 3,18, 2, 10000
19, 2, 0, 4,25, 2, 10000
12, 2, 0, 2,16, 2, 10000
13, 2, 0, 9,24, 2, 10000
11, 2, 0, 0,13, 2, 10000
9, 2, 0, 4,15, 2, 10000
18, 2, 0, 2,22, 2, 10000
8, 2, 0, 5,15, 2, 10000
12, 2, 0, 7,21, 2, 10000
13, 2, 0, 2,17, 2, 10000
11, 2, 0, 6,19, 2, 10000
14, 2, 0, 4,20, 2, 10000
13, 2, 0, 8,23, 2, 10000
9, 2, 0, 4,15, 2, 10000
14, 2, 0, 7,23, 2, 10000
11, 2, 0, 6,19, 2, 10000
10, 2, 0, 1,13, 2, 10000
11, 2, 0, 3,16, 2, 10000
16, 2, 0, 3,21, 2, 10000
7, 2, 0, 5,14, 2, 10000
12, 2, 0, 3,17, 2, 10000
13, 2, 0, 4,19, 2, 10000
14, 2, 0, 4,20, 2, 10000
14, 2, 0, 5,21, 2, 10000
16, 2, 0, 2,20, 2, 10000
14, 2, 0, 3,19, 2, 10000
10, 2, 0, 5,17, 2, 10000
13, 2, 0, 5,20, 2, 10000
10, 2, 0, 3,15, 2, 10000
12, 2, 0, 3,17, 2, 10000
7, 2, 0, 4,13, 2, 10000
16, 2, 0, 5,23, 2, 10000
11, 2, 0, 1,14, 2, 10000
16, 2, 0, 5,23, 2, 10000
4, 2, 0, 8,14, 2, 10000
8, 2, 0, 6,16, 2, 10000
1, 2, 0, 2,5, 2, 10000
12, 2, 0, 1,15, 2, 10000
9, 2, 0, 3,14, 2, 10000
10, 2, 0, 5,17, 2, 10000
14, 2, 0, 8,24, 2, 10000
14, 2, 0, 3,19, 2, 10000
9, 2, 0, 1,12, 2, 10000
8, 2, 0, 2,12, 2, 10000
13, 2, 0, 7,22, 2, 10000
7, 2, 0, 4,13, 2, 10000
6, 2, 0, 1,9, 2, 10000
10, 2, 0, 3,15, 2, 10000
9, 2, 0, 2,13, 2, 10000
10, 2, 0, 2,14, 2, 10000
15, 2, 0, 4,21, 2, 10000
12, 2, 0, 1,15, 2, 10000
11, 2, 0, 3,16, 2, 10000
12, 2, 0, 5,19, 2, 10000
17, 2, 0, 2,21, 2, 10000
14, 2, 0, 2,18, 2, 10000
4, 2, 0, 2,8, 2, 10000
9, 2, 0, 5,16, 2, 10000
10, 2, 0, 1,13, 2, 10000
16, 2, 0, 2,20, 2, 10000
17, 2, 0, 2,21, 2, 10000
14, 2, 0, 5,21, 2, 10000
11, 2, 0, 5,18, 2, 10000
4, 2, 0, 3,9, 2, 10000
12, 2, 0, 4,18, 2, 10000
11, 2, 0, 4,17, 2, 10000
7, 2, 0, 2,11, 2, 10000
13, 2, 0, 3,18, 2, 10000
11, 2, 0, 4,17, 2, 10000
10, 2, 0, 2,14, 2, 10000
10, 2, 0, 7,19, 2, 10000
13, 2, 0, 4,19, 2, 10000
11, 2, 0, 5,18, 2, 10000
11, 2, 0, 6,19, 2, 10000
9, 2, 0, 3,14, 2, 10000
7, 2, 0, 0,9, 2, 10000
13, 2, 0, 0,15, 2, 10000
7, 2, 0, 3,12, 2, 10000
7, 2, 0, 7,16, 2, 10000
12, 2, 0, 1,15, 2, 10000
5, 2, 0, 7,14, 2, 10000
7, 2, 0, 4,13, 2, 10000
8, 2, 0, 6,16, 2, 10000
8, 2, 0, 2,12, 2, 10000
9, 2, 0, 3,14, 2, 10000
13, 2, 0, 6,21, 2, 10000
9, 2, 0, 2,13, 2, 10000
10, 2, 0, 5,17, 2, 10000
7, 2, 0, 5,14, 2, 10000
11, 2, 0, 2,15, 2, 10000
17, 2, 0, 5,24, 2, 10000
9, 2, 0, 5,16, 2, 10000
12, 2, 0, 4,18, 2, 10000
12, 2, 0, 3,17, 2, 10000
13, 2, 0, 6,21, 2, 10000
10, 2, 0, 3,15, 2, 10000
10, 2, 0, 3,15, 2, 10000
11, 2, 0, 2,15, 2, 10000
11, 2, 0, 2,15, 2, 10000
13, 2, 0, 1,16, 2, 10000
13, 2, 0, 6,21, 2, 10000
15, 2, 0, 2,19, 2, 10000
13, 2, 0, 5,20, 2, 10000
11, 2, 0, 3,16, 2, 10000
18, 2, 0, 3,23, 2, 10000
11, 2, 0, 4,17, 2, 10000
14, 2, 0, 4,20, 2, 10000
12, 2, 0, 3,17, 2, 10000
10, 2, 0, 4,16, 2, 10000
14, 2, 0, 2,18, 2, 10000
8, 2, 0, 0,10, 2, 10000
9, 2, 0, 1,12, 2, 10000
18, 2, 0, 5,25, 2, 10000
11, 2, 0, 2,15, 2, 10000
12, 2, 0, 6,20, 2, 10000
10, 2, 0, 4,16, 2, 10000
14, 2, 0, 5,21, 2, 10000
13, 2, 0, 2,17, 2, 10000
9, 2, 0, 9,20, 2, 10000
9, 2, 0, 3,14, 2, 10000
5, 2, 0, 2,9, 2, 10000
9, 2, 0, 0,11, 2, 10000
12, 2, 0, 4,18, 2, 10000
11, 2, 0, 6,19, 2, 10000
10, 2, 0, 2,14, 2, 10000
17, 2, 0, 6,25, 2, 10000
10, 2, 0, 3,15, 2, 10000
4, 2, 0, 7,13, 2, 10000
11, 2, 0, 2,15, 2, 10000
12, 2, 0, 2,16, 2, 10000
10, 2, 0, 4,16, 2, 10000
4, 2, 0, 4,10, 2, 10000
23, 2, 0, 3,28, 2, 10000
11, 2, 0, 8,21, 2, 10000
14, 2, 0, 6,22, 2, 10000
11, 2, 0, 4,17, 2, 10000
9, 2, 0, 7,18, 2, 10000
7, 2, 0, 3,12, 2, 10000
4, 2, 0, 4,10, 2, 10000
7, 2, 0, 3,12, 2, 10000
8, 2, 0, 0,10, 2, 10000
10, 2, 0, 3,15, 2, 10000
7, 2, 0, 1,10, 2, 10000
9, 2, 0, 2,13, 2, 10000
11, 2, 0, 0,13, 2, 10000
13, 2, 0, 2,17, 2, 10000
16, 2, 0, 5,23, 2, 10000
11, 2, 0, 4,17, 2, 10000
9, 2, 0, 6,17, 2, 10000
10, 2, 0, 5,17, 2, 10000
9, 2, 0, 4,15, 2, 10000
12, 2, 0, 1,15, 2, 10000
18, 2, 0, 5,25, 2, 10000
7, 2, 0, 4,13, 2, 10000
6, 2, 0, 3,11, 2, 10000
22, 2, 0, 1,25, 2, 10000
17, 2, 0, 7,26, 2, 10000
8, 2, 0, 5,15, 2, 10000
6, 2, 0, 5,13, 2, 10000
12, 2, 0, 3,17, 2, 10000
9, 2, 0, 5,16, 2, 10000
9, 2, 0, 1,12, 2, 10000
12, 2, 0, 2,16, 2, 10000
13, 2, 0, 3,18, 2, 10000
11, 2, 0, 4,17, 2, 10000
15, 2, 0, 6,23, 2, 10000
19, 2, 0, 4,25, 2, 10000
17, 2, 0, 3,22, 2, 10000
17, 2, 0, 3,22, 2, 10000
11, 2, 0, 1,14, 2, 10000
6, 2, 0, 8,16, 2, 10000
19, 2, 0, 4,25, 2, 10000
6, 2, 0, 3,11, 2, 10000
13, 2, 0, 4,19, 2, 10000
9, 2, 0, 0,11, 2, 10000
12, 2, 0, 0,14, 2, 10000
11, 2, 0, 3,16, 2, 10000
16, 2, 0, 5,23, 2, 10000
7, 2, 0, 2,11, 2, 10000
8, 2, 0, 6,16, 2, 10000
8, 2, 0, 5,15, 2, 10000
13, 2, 0, 5,20, 2, 10000
8, 2, 0, 7,17, 2, 10000
8, 2, 0, 6,16, 2, 10000
12, 2, 0, 3,17, 2, 10000
12, 2, 0, 5,19, 2, 10000
8, 2, 0, 4,14, 2, 10000
12, 2, 0, 3,17, 2, 10000
11, 2, 0, 6,19, 2, 10000
5, 2, 0, 4,11, 2, 10000
11, 2, 0, 2,15, 2, 10000
4, 2, 0, 4,10, 2, 10000
7, 2, 0, 9,18, 2, 10000
5, 2, 0, 3,10, 2, 10000
12, 2, 0, 5,19, 2, 10000
3, 2, 0, 4,9, 2, 10000
8, 2, 0, 4,14, 2, 10000
7, 2, 0, 4,13, 2, 10000
11, 2, 0, 3,16, 2, 10000
12, 2, 0, 4,18, 2, 10000
8, 2, 0, 1,11, 2, 10000
1, 0, 0, 3,4, 2, 10000
6, 2, 0, 1,9, 2, 10000
11, 2, 0, 2,15, 2, 10000
16, 2, 0, 4,22, 2, 10000
8, 2, 0, 2,12, 2, 10000
9, 2, 0, 3,14, 2, 10000
22, 2, 0, 8,32, 2, 10000
14, 2, 0, 3,19, 2, 10000
11, 2, 0, 2,15, 2, 10000
11, 2, 0, 5,18, 2, 10000
18, 2, 0, 2,22, 2, 10000
9, 2, 0, 1,12, 2, 10000
13, 2, 0, 3,18, 2, 10000
9, 2, 0, 5,16, 2, 10000
6, 2, 0, 3,11, 2, 10000
5, 2, 0, 5,12, 2, 10000
9, 2, 0, 5,16, 2, 10000
7, 2, 0, 3,12, 2, 10000
10, 2, 0, 3,15, 2, 10000
8, 2, 0, 4,14, 2, 10000
10, 2, 0, 2,14, 2, 10000
11, 2, 0, 4,17, 2, 10000
12, 2, 0, 1,15, 2, 10000
10, 2, 0, 2,14, 2, 10000
15, 2, 0, 3,20, 2, 10000
13, 2, 0, 3,18, 2, 10000
11, 2, 0, 2,15, 2, 10000
15, 2, 0, 4,21, 2, 10000
11, 2, 0, 4,17, 2, 10000
5, 2, 0, 2,9, 2, 10000
13, 2, 0, 3,18, 2, 10000
5, 2, 0, 5,12, 2, 10000
6, 2, 0, 7,15, 2, 10000
18, 2, 0, 2,22, 2, 10000
12, 2, 0, 2,16, 2, 10000
16, 2, 0, 6,24, 2, 10000
11, 2, 0, 5,18, 2, 10000
9, 2, 0, 4,15, 2, 10000
12, 2, 0, 1,15, 2, 10000
12, 2, 0, 4,18, 2, 10000
9, 2, 0, 5,16, 2, 10000
7, 2, 0, 1,10, 2, 10000
15, 2, 0, 3,20, 2, 10000
12, 2, 0, 6,20, 2, 10000
14, 2, 0, 2,18, 2, 10000
5, 2, 0, 3,10, 2, 10000
9, 2, 0, 2,13, 2, 10000
4, 2, 0, 2,8, 2, 10000
14, 2, 0, 4,20, 2, 10000
8, 2, 0, 6,16, 2, 10000
13, 2, 0, 6,21, 2, 10000
12, 2, 0, 2,16, 2, 10000
15, 2, 0, 2,19, 2, 10000
11, 2, 0, 0,13, 2, 10000
8, 2, 0, 7,17, 2, 10000
11, 2, 0, 1,14, 2, 10000
15, 2, 0, 3,20, 2, 10000
10, 2, 0, 1,13, 2, 10000
14, 2, 0, 2,18, 2, 10000
12, 2, 0, 5,19, 2, 10000
12, 2, 0, 2,16, 2, 10000
5, 2, 0, 5,12, 2, 10000
10, 2, 0, 2,14, 2, 10000
9, 2, 0, 6,17, 2, 10000
9, 2, 0, 1,12, 2, 10000
15, 2, 0, 3,20, 2, 10000
13, 2, 0, 2,17, 2, 10000
7, 2, 0, 1,10, 2, 10000
8, 2, 0, 1,11, 2, 10000
12, 2, 0, 2,16, 2, 10000
9, 2, 0, 5,16, 2, 10000
7, 2, 0, 3,12, 2, 10000
8, 2, 0, 3,13, 2, 10000
9, 2, 0, 2,13, 2, 10000
8, 2, 0, 6,16, 2, 10000
12, 2, 0, 7,21, 2, 10000
13, 2, 0, 3,18, 2, 10000
17, 2, 0, 5,24, 2, 10000
12, 2, 0, 2,16, 2, 10000
16, 2, 0, 4,22, 2, 10000
11, 2, 0, 4,17, 2, 10000
14, 2, 0, 0,16, 2, 10000
18, 2, 0, 4,24, 2, 10000
8, 2, 0, 5,15, 2, 10000
5, 2, 0, 1,8, 2, 10000
14, 2, 0, 2,18, 2, 10000
18, 2, 0, 3,23, 2, 10000
13, 2, 0, 2,17, 2, 10000
14, 2, 0, 2,18, 2, 10000
12, 2, 0, 1,15, 2, 10000
19, 2, 0, 1,22, 2, 10000
9, 2, 0, 3,14, 2, 10000
12, 2, 0, 4,18, 2, 10000
12, 2, 0, 3,17, 2, 10000
10, 2, 0, 4,16, 2, 10000
14, 2, 0, 4,20, 2, 10000
14, 2, 0, 5,21, 2, 10000
13, 2, 0, 3,18, 2, 10000
12, 2, 0, 3,17, 2, 10000
7, 2, 0, 1,10, 2, 10000
7, 2, 0, 2,11, 2, 10000
10, 2, 0, 2,14, 2, 10000
14, 2, 0, 6,22, 2, 10000
5, 2, 0, 4,11, 2, 10000
14, 2, 0, 3,19, 2, 10000
12, 2, 0, 10,24, 2, 10000
17, 2, 0, 3,22, 2, 10000
8, 2, 0, 0,10, 2, 10000
11, 2, 0, 3,16, 2, 10000
5, 2, 0, 3,10, 2, 10000
10, 2, 0, 4,16, 2, 10000
15, 2, 0, 3,20, 2, 10000
10, 2, 0, 5,17, 2, 10000
8, 2, 0, 2,12, 2, 10000
10, 2, 0, 5,17, 2, 10000
11, 2, 0, 3,16, 2, 10000
17, 2, 0, 6,25, 2, 10000
13, 2, 0, 0,15, 2, 10000
17, 2, 0, 4,23, 2, 10000
12, 2, 0, 4,18, 2, 10000
8, 2, 0, 3,13, 2, 10000
10, 2, 0, 0,12, 2, 10000
9, 2, 0, 1,12, 2, 10000
10, 2, 0, 5,17, 2, 10000
6, 2, 0, 2,10, 2, 10000
11, 2, 0, 4,17, 2, 10000
12, 2, 0, 1,15, 2, 10000
9, 2, 0, 4,15, 2, 10000
5, 2, 0, 3,10, 2, 10000
11, 2, 0, 6,19, 2, 10000
10, 2, 0, 5,17, 2, 10000
14, 2, 0, 3,19, 2, 10000
6, 2, 0, 4,12, 2, 10000
16, 2, 0, 2,20, 2, 10000
11, 2, 0, 5,18, 2, 10000
7, 2, 0, 2,11, 2, 10000
12, 2, 0, 3,17, 2, 10000
11, 2, 0, 1,14, 2, 10000
13, 2, 0, 0,15, 2, 10000
9, 2, 0, 6,17, 2, 10000
16, 2, 0, 3,21, 2, 10000
4, 2, 0, 2,8, 2, 10000
14, 2, 0, 3,19, 2, 10000
13, 2, 0, 4,19, 2, 10000
13, 2, 0, 2,17, 2, 10000
14, 2, 0, 3,19, 2, 10000
4, 2, 0, 4,10, 2, 10000
12, 2, 0, 4,18, 2, 10000
14, 2, 0, 2,18, 2, 10000
9, 2, 0, 5,16, 2, 10000
7, 2, 0, 5,14, 2, 10000
12, 2, 0, 5,19, 2, 10000
7, 2, 0, 4,13, 2, 10000
6, 2, 0, 3,11, 2, 10000
15, 2, 0, 2,19, 2, 10000
13, 2, 0, 4,19, 2, 10000
7, 2, 0, 2,11, 2, 10000
6, 2, 0, 0,8, 2, 10000
6, 2, 0, 3,11, 2, 10000
11, 2, 0, 1,14, 2, 10000
14, 2, 0, 4,20, 2, 10000
6, 2, 0, 8,16, 2, 10000
16, 2, 0, 5,23, 2, 10000
10, 2, 0, 2,14, 2, 10000
8, 2, 0, 3,13, 2, 10000
6, 2, 0, 7,15, 2, 10000
11, 2, 0, 3,16, 2, 10000
13, 2, 0, 4,19, 2, 10000
7, 2, 0, 5,14, 2, 10000
9, 2, 0, 1,12, 2, 10000
8, 2, 0, 3,13, 2, 10000
10, 2, 0, 3,15, 2, 10000
10, 2, 0, 2,14, 2, 10000
11, 2, 0, 4,17, 2, 10000
6, 2, 0, 5,13, 2, 10000
17, 2, 0, 3,22, 2, 10000
9, 2, 0, 5,16, 2, 10000
7, 2, 0, 2,11, 2, 10000
3, 2, 0, 4,9, 2, 10000
5, 2, 0, 2,9, 2, 10000
12, 2, 0, 5,19, 2, 10000
11, 2, 0, 3,16, 2, 10000
6, 2, 0, 3,11, 2, 10000
8, 2, 0, 2,12, 2, 10000
9, 2, 0, 9,20, 2, 10000
14, 2, 0, 8,24, 2, 10000
14, 2, 0, 2,18, 2, 10000
7, 2, 0, 3,12, 2, 10000
5, 2, 0, 2,9, 2, 10000
16, 2, 0, 6,24, 2, 10000
13, 2, 0, 1,16, 2, 10000
10, 2, 0, 6,18, 2, 10000
7, 2, 0, 4,13, 2, 10000
7, 2, 0, 2,11, 2, 10000
11, 2, 0, 2,15, 2, 10000
15, 2, 0, 3,20, 2, 10000
6, 2, 0, 3,11, 2, 10000
5, 2, 0, 7,14, 2, 10000
9, 2, 0, 3,14, 2, 10000
9, 2, 0, 5,16, 2, 10000
9, 2, 0, 6,17, 2, 10000
9, 2, 0, 1,12, 2, 10000
15, 2, 0, 5,22, 2, 10000
13, 2, 0, 6,21, 2, 10000
8, 2, 0, 3,13, 2, 10000
12, 2, 0, 5,19, 2, 10000
11, 2, 0, 1,14, 2, 10000
9, 2, 0, 1,12, 2, 10000
6, 2, 0, 2,10, 2, 10000
13, 2, 0, 6,21, 2, 10000
9, 2, 0, 4,15, 2, 10000
10, 2, 0, 8,20, 2, 10000
7, 2, 0, 3,12, 2, 10000
13, 2, 0, 2,17, 2, 10000
5, 2, 0, 5,12, 2, 10000
7, 2, 0, 3,12, 2, 10000
11, 2, 0, 7,20, 2, 10000
18, 2, 0, 4,24, 2, 10000
11, 2, 0, 1,14, 2, 10000
11, 2, 0, 3,16, 2, 10000
9, 2, 0, 3,14, 2, 10000
13, 2, 0, 3,18, 2, 10000
10, 2, 0, 3,15, 2, 10000
11, 2, 0, 0,13, 2, 10000
14, 2, 0, 4,20, 2, 10000
12, 2, 0, 0,14, 2, 10000
12, 2, 0, 3,17, 2, 10000
9, 2, 0, 6,17, 2, 10000
10, 2, 0, 3,15, 2, 10000
14, 2, 0, 2,18, 2, 10000
6, 2, 0, 6,14, 2, 10000
11, 2, 0, 1,14, 2, 10000
11, 2, 0, 7,20, 2, 10000
13, 2, 0, 6,21, 2, 10000
10, 2, 0, 5,17, 2, 10000
11, 2, 0, 2,15, 2, 10000
10, 2, 0, 4,16, 2, 10000
10, 2, 0, 4,16, 2, 10000
12, 2, 0, 2,16, 2, 10000
11, 2, 0, 2,15, 2, 10000
11, 2, 0, 6,19, 2, 10000
14, 2, 0, 2,18, 2, 10000
8, 2, 0, 4,14, 2, 10000
16, 2, 0, 2,20, 2, 10000
7, 2, 0, 3,12, 2, 10000
12, 2, 0, 2,16, 2, 10000
9, 2, 0, 3,14, 2, 10000
11, 2, 0, 3,16, 2, 10000
11, 2, 0, 4,17, 2, 10000
7, 2, 0, 4,13, 2, 10000
7, 2, 0, 1,10, 2, 10000
7, 2, 0, 2,11, 2, 10000
9, 2, 0, 2,13, 2, 10000
8, 2, 0, 1,11, 2, 10000
15, 2, 0, 2,19, 2, 10000
10, 2, 0, 3,15, 2, 10000
6, 2, 0, 3,11, 2, 10000
18, 2, 0, 3,23, 2, 10000
9, 2, 0, 2,13, 2, 10000
8, 2, 0, 4,14, 2, 10000
9, 2, 0, 2,13, 2, 10000
17, 2, 0, 3,22, 2, 10000
9, 2, 0, 4,15, 2, 10000
7, 2, 0, 2,11, 2, 10000
10, 2, 0, 2,14, 2, 10000
10, 2, 0, 3,15, 2, 10000
10, 2, 0, 0,12, 2, 10000
7, 2, 0, 5,14, 2, 10000
8, 2, 0, 2,12, 2, 10000
12, 2, 0, 2,16, 2, 10000
16, 2, 0, 2,20, 2, 10000
7, 2, 0, 4,13, 2, 10000
11, 2, 0, 2,15, 2, 10000
4, 2, 0, 3,9, 2, 10000
6, 2, 0, 5,13, 2, 10000
17, 2, 0, 2,21, 2, 10000
7, 2, 0, 2,11, 2, 10000
6, 2, 0, 0,8, 2, 10000
9, 2, 0, 5,16, 2, 10000
15, 2, 0, 1,18, 2, 10000
2, 2, 0, 7,11, 2, 10000
5, 2, 0, 3,10, 2, 10000
11, 2, 0, 1,14, 2, 10000
8, 2, 0, 1,11, 2, 10000
6, 2, 0, 3,11, 2, 10000
7, 2, 0, 3,12, 2, 10000
7, 2, 0, 3,12, 2, 10000
12, 2, 0, 6,20, 2, 10000
12, 2, 0, 6,20, 2, 10000
2, 2, 0, 1,5, 2, 10000
8, 2, 0, 5,15, 2, 10000
11, 2, 0, 5,18, 2, 10000
13, 2, 0, 4,19, 2, 10000
14, 2, 0, 5,21, 2, 10000
10, 2, 0, 3,15, 2, 10000
14, 2, 0, 3,19, 2, 10000
16, 2, 0, 2,20, 2, 10000
15, 2, 0, 4,21, 2, 10000
6, 2, 0, 3,11, 2, 10000
10, 2, 0, 1,13, 2, 10000
13, 2, 0, 5,20, 2, 10000
12, 2, 0, 4,18, 2, 10000
8, 2, 0, 5,15, 2, 10000
12, 2, 0, 5,19, 2, 10000
7, 2, 0, 2,11, 2, 10000
10, 2, 0, 2,14, 2, 10000
13, 2, 0, 2,17, 2, 10000
12, 2, 0, 2,16, 2, 10000
10, 2, 0, 1,13, 2, 10000
9, 2, 0, 3,14, 2, 10000
18, 2, 0, 1,21, 2, 10000
15, 2, 0, 3,20, 2, 10000
18, 2, 0, 3,23, 2, 10000
9, 2, 0, 1,12, 2, 10000
7, 2, 0, 3,12, 2, 10000
9, 2, 0, 1,12, 2, 10000
15, 2, 0, 3,20, 2, 10000
11, 2, 0, 2,15, 2, 10000
10, 2, 0, 1,13, 2, 10000
5, 2, 0, 2,9, 2, 10000
13, 2, 0, 4,19, 2, 10000
15, 2, 0, 1,18, 2, 10000
12, 2, 0, 6,20, 2, 10000
6, 2, 0, 3,11, 2, 10000
12, 2, 0, 4,18, 2, 10000
13, 2, 0, 2,17, 2, 10000
9, 2, 0, 7,18, 2, 10000
10, 2, 0, 1,13, 2, 10000
11, 2, 0, 4,17, 2, 10000
11, 2, 0, 1,14, 2, 10000
7, 2, 0, 3,12, 2, 10000
8, 2, 0, 4,14, 2, 10000
10, 2, 0, 5,17, 2, 10000
8, 2, 0, 2,12, 2, 10000
11, 2, 0, 2,15, 2, 10000
10, 2, 0, 5,17, 2, 10000
9, 2, 0, 3,14, 2, 10000
2, 2, 0, 4,8, 2, 10000
9, 2, 0, 1,12, 2, 10000
8, 2, 0, 1,11, 2, 10000
9, 2, 0, 6,17, 2, 10000
7, 2, 0, 3,12, 2, 10000
8, 2, 0, 2,12, 2, 10000
9, 2, 0, 3,14, 2, 10000
7, 2, 0, 2,11, 2, 10000
15, 2, 0, 4,21, 2, 10000
9, 2, 0, 5,16, 2, 10000
8, 2, 0, 3,13, 2, 10000
5, 2, 0, 4,11, 2, 10000
10, 2, 0, 3,15, 2, 10000
8, 2, 0, 2,12, 2, 10000
11, 2, 0, 2,15, 2, 10000
11, 2, 0, 2,15, 2, 10000
8, 2, 0, 3,13, 2, 10000
8, 2, 0, 1,11, 2, 10000
14, 2, 0, 5,21, 2, 10000
9, 2, 0, 3,14, 2, 10000
12, 2, 0, 4,18, 2, 10000
13, 2, 0, 4,19, 2, 10000
12, 2, 0, 4,18, 2, 10000
13, 2, 0, 1,16, 2, 10000
8, 2, 0, 1,11, 2, 10000
12, 2, 0, 3,17, 2, 10000
7, 2, 0, 2,11, 2, 10000
14, 2, 0, 4,20, 2, 10000
6, 2, 0, 1,9, 2, 10000
6, 2, 0, 6,14, 2, 10000
4, 2, 0, 2,8, 2, 10000
10, 2, 0, 5,17, 2, 10000
12, 2, 0, 2,16, 2, 10000
12, 2, 0, 7,21, 2, 10000
9, 2, 0, 0,11, 2, 10000
11, 2, 0, 4,17, 2, 10000
13, 2, 0, 2,17, 2, 10000
12, 2, 0, 5,19, 2, 10000
8, 2, 0, 3,13, 2, 10000
14, 2, 0, 3,19, 2, 10000
10, 2, 0, 0,12, 2, 10000
15, 2, 0, 5,22, 2, 10000
6, 2, 0, 5,13, 2, 10000
13, 2, 0, 6,21, 2, 10000
9, 2, 0, 2,13, 2, 10000
12, 2, 0, 4,18, 2, 10000
2, 2, 0, 2,6, 2, 10000
10, 2, 0, 3,15, 2, 10000
12, 2, 0, 2,16, 2, 10000
8, 2, 0, 4,14, 2, 10000
8, 2, 0, 7,17, 2, 10000
16, 2, 0, 2,20, 2, 10000
7, 2, 0, 2,11, 2, 10000
13, 2, 0, 5,20, 2, 10000
13, 2, 0, 1,16, 2, 10000
5, 2, 0, 3,10, 2, 10000
10, 2, 0, 4,16, 2, 10000
4, 2, 0, 5,11, 2, 10000
8, 2, 0, 4,14, 2, 10000
14, 2, 0, 1,17, 2, 10000
13, 2, 0, 1,16, 2, 10000
11, 2, 0, 1,14, 2, 10000
10, 2, 0, 2,14, 2, 10000
8, 2, 0, 1,11, 2, 10000
8, 2, 0, 4,14, 2, 10000
13, 2, 0, 6,21, 2, 10000
6, 2, 0, 4,12, 2, 10000
12, 2, 0, 6,20, 2, 10000
13, 2, 0, 2,17, 2, 10000
11, 2, 0, 1,14, 2, 10000
7, 2, 0, 3,12, 2, 10000
16, 2, 0, 5,23, 2, 10000
13, 2, 0, 3,18, 2, 10000
7, 2, 0, 4,13, 2, 10000
10, 2, 0, 4,16, 2, 10000
10, 2, 0, 2,14, 2, 10000
14, 2, 0, 2,18, 2, 10000
9, 2, 0, 4,15, 2, 10000
5, 2, 0, 5,12, 2, 10000
10, 2, 0, 2,14, 2, 10000
9, 2, 0, 2,13, 2, 10000
11, 2, 0, 1,14, 2, 10000
13, 2, 0, 5,20, 2, 10000
8, 2, 0, 4,14, 2, 10000
13, 2, 0, 5,20, 2, 10000
14, 2, 0, 8,24, 2, 10000
14, 2, 0, 2,18, 2, 10000
13, 2, 0, 1,16, 2, 10000
6, 2, 0, 3,11, 2, 10000
8, 2, 0, 2,12, 2, 10000
8, 2, 0, 6,16, 2, 10000
9, 2, 0, 5,16, 2, 10000
11, 2, 0, 3,16, 2, 10000
11, 2, 0, 3,16, 2, 10000
8, 2, 0, 2,12, 2, 10000
4, 2, 0, 4,10, 2, 10000
13, 2, 0, 2,17, 2, 10000
8, 2, 0, 3,13, 2, 10000
7, 2, 0, 1,10, 2, 10000
10, 2, 0, 5,17, 2, 10000
13, 2, 0, 3,18, 2, 10000
5, 2, 0, 3,10, 2, 10000
4, 2, 0, 3,9, 2, 10000
17, 2, 0, 4,23, 2, 10000
12, 2, 0, 6,20, 2, 10000
10, 2, 0, 2,14, 2, 10000
14, 2, 0, 2,18, 2, 10000
5, 2, 0, 2,9, 2, 10000
15, 2, 0, 4,21, 2, 10000
7, 2, 0, 2,11, 2, 10000
12, 2, 0, 2,16, 2, 10000
20, 2, 0, 3,25, 2, 10000
6, 2, 0, 0,8, 2, 10000
9, 2, 0, 3,14, 2, 10000
16, 2, 0, 3,21, 2, 10000
9, 2, 0, 4,15, 2, 10000
12, 2, 0, 1,15, 2, 10000
18, 2, 0, 4,24, 2, 10000
13, 2, 0, 2,17, 2, 10000
10, 2, 0, 3,15, 2, 10000
12, 2, 0, 0,14, 2, 10000
5, 2, 0, 6,13, 2, 10000
21, 2, 0, 9,32, 2, 10000
19, 2, 0, 6,27, 2, 10000
7, 2, 0, 5,14, 2, 10000
14, 2, 0, 5,21, 2, 10000
7, 2, 0, 6,15, 2, 10000
6, 2, 0, 3,11, 2, 10000
9, 2, 0, 4,15, 2, 10000
11, 2, 0, 5,18, 2, 10000
12, 2, 0, 6,20, 2, 10000
11, 2, 0, 2,15, 2, 10000
8, 2, 0, 3,13, 2, 10000
10, 2, 0, 2,14, 2, 10000
14, 2, 0, 3,19, 2, 10000
9, 2, 0, 4,15, 2, 10000
5, 2, 0, 5,12, 2, 10000
11, 2, 0, 6,19, 2, 10000
10, 2, 0, 2,14, 2, 10000
11, 2, 0, 4,17, 2, 10000
10, 2, 0, 6,18, 2, 10000
5, 2, 0, 2,9, 2, 10000
11, 2, 0, 4,17, 2, 10000
12, 2, 0, 1,15, 2, 10000
6, 2, 0, 1,9, 2, 10000
9, 2, 0, 3,14, 2, 10000
8, 2, 0, 2,12, 2, 10000
6, 2, 0, 5,13, 2, 10000
16, 2, 0, 3,21, 2, 10000
7, 2, 0, 4,13, 2, 10000
7, 2, 0, 6,15, 2, 10000
9, 2, 0, 2,13, 2, 10000
6, 2, 0, 4,12, 2, 10000
6, 2, 0, 1,9, 2, 10000
9, 2, 0, 1,12, 2, 10000
7, 2, 0, 3,12, 2, 10000
14, 2, 0, 3,19, 2, 10000
7, 2, 0, 3,12, 2, 10000
10, 2, 0, 4,16, 2, 10000
11, 2, 0, 2,15, 2, 10000
6, 2, 0, 1,9, 2, 10000
10, 2, 0, 1,13, 2, 10000
7, 2, 0, 3,12, 2, 10000
9, 2, 0, 4,15, 2, 10000
5, 2, 0, 7,14, 2, 10000
5, 2, 0, 4,11, 2, 10000
3, 2, 0, 1,6, 2, 10000
12, 2, 0, 1,15, 2, 10000
6, 2, 0, 2,10, 2, 10000
8, 2, 0, 7,17, 2, 10000
6, 2, 0, 3,11, 2, 10000
16, 2, 0, 5,23, 2, 10000
11, 2, 0, 3,16, 2, 10000
11, 2, 0, 3,16, 2, 10000
10, 2, 0, 3,15, 2, 10000
8, 2, 0, 2,12, 2, 10000
9, 2, 0, 3,14, 2, 10000
15, 2, 0, 3,20, 2, 10000
10, 2, 0, 0,12, 2, 10000
11, 2, 0, 3,16, 2, 10000
13, 2, 0, 0,15, 2, 10000
11, 2, 0, 2,15, 2, 10000
10, 2, 0, 1,13, 2, 10000
14, 2, 0, 6,22, 2, 10000
7, 2, 0, 2,11, 2, 10000
12, 2, 0, 4,18, 2, 10000
13, 2, 0, 5,20, 2, 10000
8, 2, 0, 4,14, 2, 10000
11, 2, 0, 6,19, 2, 10000
16, 2, 0, 2,20, 2, 10000
15, 2, 0, 3,20, 2, 10000
18, 2, 0, 6,26, 2, 10000
3, 2, 0, 2,7, 2, 10000
9, 2, 0, 0,11, 2, 10000
7, 2, 0, 6,15, 2, 10000
11, 2, 0, 1,14, 2, 10000
9, 2, 0, 4,15, 2, 10000
10, 2, 0, 2,14, 2, 10000
7, 2, 0, 8,17, 2, 10000
6, 2, 0, 3,11, 2, 10000
12, 2, 0, 2,16, 2, 10000
9, 2, 0, 6,17, 2, 10000
11, 2, 0, 2,15, 2, 10000
9, 2, 0, 3,14, 2, 10000
7, 2, 0, 5,14, 2, 10000
2, 1, 0, 4,7, 2, 10000
14, 2, 0, 6,22, 2, 10000
16, 2, 0, 3,21, 2, 10000
7, 2, 0, 6,15, 2, 10000
9, 2, 0, 7,18, 2, 10000
9, 2, 0, 3,14, 2, 10000
14, 2, 0, 1,17, 2, 10000
9, 2, 0, 2,13, 2, 10000
17, 2, 0, 3,22, 2, 10000
5, 2, 0, 3,10, 2, 10000
8, 2, 0, 5,15, 2, 10000
11, 2, 0, 2,15, 2, 10000
8, 2, 0, 5,15, 2, 10000
5, 2, 0, 4,11, 2, 10000
18, 2, 0, 2,22, 2, 10000
7, 2, 0, 0,9, 2, 10000
5, 2, 0, 3,10, 2, 10000
4, 2, 0, 3,9, 2, 10000
15, 2, 0, 2,19, 2, 10000
13, 2, 0, 4,19, 2, 10000
11, 2, 0, 2,15, 2, 10000
5, 2, 0, 10,17, 2, 10000
7, 2, 0, 1,10, 2, 10000
8, 2, 0, 4,14, 2, 10000
12, 2, 0, 1,15, 2, 10000
11, 2, 0, 4,17, 2, 10000
8, 2, 0, 0,10, 2, 10000
10, 2, 0, 6,18, 2, 10000
5, 2, 0, 3,10, 2, 10000
5, 2, 0, 2,9, 2, 10000
9, 2, 0, 2,13, 2, 10000
8, 2, 0, 4,14, 2, 10000
12, 2, 0, 5,19, 2, 10000
14, 2, 0, 2,18, 2, 10000
4, 2, 0, 4,10, 2, 10000
5, 2, 0, 3,10, 2, 10000
5, 2, 0, 5,12, 2, 10000
10, 2, 0, 4,16, 2, 10000
9, 2, 0, 2,13, 2, 10000
9, 2, 0, 3,14, 2, 10000
10, 2, 0, 3,15, 2, 10000
8, 2, 0, 6,16, 2, 10000
9, 2, 0, 7,18, 2, 10000
10, 2, 0, 2,14, 2, 10000
8, 2, 0, 3,13, 2, 10000
8, 2, 0, 9,19, 2, 10000
14, 2, 0, 3,19, 2, 10000
5, 2, 0, 6,13, 2, 10000
12, 2, 0, 2,16, 2, 10000
1, 2, 0, 2,5, 2, 10000
10, 2, 0, 4,16, 2, 10000
14, 2, 0, 4,20, 2, 10000
8, 2, 0, 2,12, 2, 10000
9, 2, 0, 1,12, 2, 10000
11, 2, 0, 1,14, 2, 10000
12, 2, 0, 1,15, 2, 10000
13, 2, 0, 1,16, 2, 10000
10, 2, 0, 5,17, 2, 10000
4, 2, 0, 4,10, 2, 10000
7, 2, 0, 0,9, 2, 10000
8, 2, 0, 3,13, 2, 10000
9, 2, 0, 2,13, 2, 10000
2, 2, 0, 2,6, 2, 10000
4, 2, 0, 1,7, 2, 10000
11, 2, 0, 1,14, 2, 10000
6, 2, 0, 1,9, 2, 10000
11, 2, 0, 3,16, 2, 10000
20, 2, 0, 3,25, 2, 10000
9, 2, 0, 7,18, 2, 10000
12, 2, 0, 3,17, 2, 10000
3, 2, 0, 3,8, 2, 10000
12, 2, 0, 3,17, 2, 10000
9, 2, 0, 2,13, 2, 10000
5, 2, 0, 5,12, 2, 10000
7, 2, 0, 3,12, 2, 10000
10, 2, 0, 4,16, 2, 10000
7, 2, 0, 4,13, 2, 10000
13, 2, 0, 5,20, 2, 10000
6, 2, 0, 4,12, 2, 10000
1, 1, 0, 3,5, 2, 10000
10, 2, 0, 3,15, 2, 10000
10, 2, 0, 1,13, 2, 10000
11, 2, 0, 3,16, 2, 10000
5, 2, 0, 6,13, 2, 10000
11, 2, 0, 4,17, 2, 10000
14, 2, 0, 1,17, 2, 10000
9, 2, 0, 6,17, 2, 10000
8, 2, 0, 3,13, 2, 10000
8, 2, 0, 2,12, 2, 10000
9, 2, 0, 2,13, 2, 10000
8, 2, 0, 1,11, 2, 10000
8, 2, 0, 1,11, 2, 10000
12, 2, 0, 6,20, 2, 10000
9, 2, 0, 2,13, 2, 10000
6, 2, 0, 2,10, 2, 10000
5, 2, 0, 2,9, 2, 10000
13, 2, 0, 4,19, 2, 10000
8, 2, 0, 2,12, 2, 10000
12, 2, 0, 3,17, 2, 10000
10, 2, 0, 4,16, 2, 10000
14, 2, 0, 2,18, 2, 10000
5, 2, 0, 3,10, 2, 10000
5, 2, 0, 4,11, 2, 10000
15, 2, 0, 4,21, 2, 10000
13, 2, 0, 2,17, 2, 10000
12, 2, 0, 3,17, 2, 10000
14, 2, 0, 2,18, 2, 10000
6, 2, 0, 5,13, 2, 10000
10, 2, 0, 3,15, 2, 10000
6, 2, 0, 7,15, 2, 10000
12, 2, 0, 4,18, 2, 10000
16, 2, 0, 6,24, 2, 10000
15, 2, 0, 2,19, 2, 10000
16, 2, 0, 1,19, 2, 10000
8, 2, 0, 0,10, 2, 10000
10, 2, 0, 2,14, 2, 10000
6, 2, 0, 4,12, 2, 10000
6, 2, 0, 5,13, 2, 10000
4, 2, 0, 5,11, 2, 10000
12, 2, 0, 6,20, 2, 10000
9, 2, 0, 3,14, 2, 10000
14, 2, 0, 5,21, 2, 10000
9, 2, 0, 1,12, 2, 10000
7, 2, 0, 3,12, 2, 10000
11, 2, 0, 4,17, 2, 10000
10, 2, 0, 0,12, 2, 10000
7, 2, 0, 1,10, 2, 10000
13, 2, 0, 4,19, 2, 10000
13, 2, 0, 2,17, 2, 10000
1, 2, 0, 1,4, 2, 10000
11, 2, 0, 1,14, 2, 10000
6, 2, 0, 1,9, 2, 10000
9, 2, 0, 1,12, 2, 10000
6, 2, 0, 4,12, 2, 10000
6, 2, 0, 3,11, 2, 10000
14, 2, 0, 5,21, 2, 10000
13, 2, 0, 2,17, 2, 10000
11, 2, 0, 1,14, 2, 10000
11, 2, 0, 6,19, 2, 10000
4, 2, 0, 3,9, 2, 10000
9, 2, 0, 4,15, 2, 10000
11, 2, 0, 3,16, 2, 10000
10, 2, 0, 0,12, 2, 10000
8, 2, 0, 2,12, 2, 10000
3, 2, 0, 4,9, 2, 10000
11, 2, 0, 3,16, 2, 10000
9, 2, 0, 1,12, 2, 10000
15, 2, 0, 5,22, 2, 10000
2, 2, 0, 4,8, 2, 10000
14, 2, 0, 3,19, 2, 10000
12, 2, 0, 4,18, 2, 10000
11, 2, 0, 1,14, 2, 10000
10, 2, 0, 3,15, 2, 10000
6, 2, 0, 4,12, 2, 10000
11, 2, 0, 5,18, 2, 10000
14, 2, 0, 5,21, 2, 10000
2, 1, 0, 2,5, 2, 10000
9, 2, 0, 4,15, 2, 10000
11, 2, 0, 4,17, 2, 10000
10, 2, 0, 4,16, 2, 10000
2, 2, 0, 5,9, 2, 10000
8, 2, 0, 2,12, 2, 10000
9, 2, 0, 3,14, 2, 10000
10, 2, 0, 4,16, 2, 10000
11, 2, 0, 1,14, 2, 10000
9, 2, 0, 3,14, 2, 10000
9, 2, 0, 4,15, 2, 10000
8, 2, 0, 2,12, 2, 10000
5, 2, 0, 1,8, 2, 10000
6, 2, 0, 5,13, 2, 10000
16, 2, 0, 6,24, 2, 10000
2, 1, 0, 2,5, 2, 10000
8, 2, 0, 4,14, 2, 10000
5, 2, 0, 3,10, 2, 10000
10, 2, 0, 6,18, 2, 10000
12, 2, 0, 4,18, 2, 10000
11, 2, 0, 2,15, 2, 10000
9, 2, 0, 2,13, 2, 10000
7, 2, 0, 5,14, 2, 10000
5, 2, 0, 2,9, 2, 10000
6, 2, 0, 4,12, 2, 10000
9, 2, 0, 3,14, 2, 10000
10, 2, 0, 0,12, 2, 10000
4, 2, 0, 7,13, 2, 10000
10, 2, 0, 7,19, 2, 10000
13, 2, 0, 3,18, 2, 10000
9, 2, 0, 5,16, 2, 10000
17, 2, 0, 5,24, 2, 10000
8, 2, 0, 4,14, 2, 10000
6, 2, 0, 6,14, 2, 10000
13, 2, 0, 3,18, 2, 10000
12, 2, 0, 8,22, 2, 10000
9, 2, 0, 2,13, 2, 10000
8, 2, 0, 1,11, 2, 10000
10, 2, 0, 3,15, 2, 10000
7, 2, 0, 3,12, 2, 10000
2, 2, 0, 3,7, 2, 10000
8, 2, 0, 2,12, 2, 10000
12, 2, 0, 3,17, 2, 10000
6, 2, 0, 3,11, 2, 10000
5, 2, 0, 3,10, 2, 10000
9, 2, 0, 2,13, 2, 10000
2, 2, 0, 2,6, 2, 10000
10, 2, 0, 3,15, 2, 10000
11, 2, 0, 4,17, 2, 10000
12, 2, 0, 1,15, 2, 10000
12, 2, 0, 4,18, 2, 10000
6, 2, 0, 1,9, 2, 10000
12, 2, 0, 4,18, 2, 10000
14, 2, 0, 3,19, 2, 10000
7, 2, 0, 3,12, 2, 10000
12, 2, 0, 1,15, 2, 10000
10, 2, 0, 1,13, 2, 10000
5, 2, 0, 3,10, 2, 10000
5, 2, 0, 4,11, 2, 10000
8, 2, 0, 4,14, 2, 10000
18, 2, 0, 4,24, 2, 10000
7, 2, 0, 4,13, 2, 10000
10, 2, 0, 4,16, 2, 10000
12, 2, 0, 2,16, 2, 10000
3, 2, 0, 6,11, 2, 10000
7, 2, 0, 8,17, 2, 10000
10, 2, 0, 3,15, 2, 10000
8, 2, 0, 2,12, 2, 10000
13, 2, 0, 3,18, 2, 10000
9, 2, 0, 3,14, 2, 10000
11, 2, 0, 4,17, 2, 10000
6, 2, 0, 3,11, 2, 10000
11, 2, 0, 5,18, 2, 10000
14, 2, 0, 3,19, 2, 10000
6, 2, 0, 8,16, 2, 10000
9, 2, 0, 1,12, 2, 10000
9, 2, 0, 3,14, 2, 10000
13, 2, 0, 2,17, 2, 10000
2, 2, 0, 2,6, 2, 10000
5, 2, 0, 7,14, 2, 10000
12, 2, 0, 1,15, 2, 10000
7, 2, 0, 5,14, 2, 10000
6, 2, 0, 2,10, 2, 10000
9, 2, 0, 3,14, 2, 10000
5, 2, 0, 8,15, 2, 10000
14, 2, 0, 5,21, 2, 10000
6, 2, 0, 1,9, 2, 10000
14, 2, 0, 2,18, 2, 10000
7, 2, 0, 4,13, 2, 10000
8, 2, 0, 3,13, 2, 10000
10, 2, 0, 3,15, 2, 10000
7, 2, 0, 3,12, 2, 10000
13, 2, 0, 3,18, 2, 10000
11, 2, 0, 4,17, 2, 10000
10, 2, 0, 2,14, 2, 10000
9, 2, 0, 1,12, 2, 10000
6, 2, 0, 2,10, 2, 10000
7, 2, 0, 0,9, 2, 10000
9, 2, 0, 3,14, 2, 10000
10, 2, 0, 3,15, 2, 10000
10, 2, 0, 3,15, 2, 10000
11, 2, 0, 6,19, 2, 10000
5, 2, 0, 2,9, 2, 10000
8, 2, 0, 4,14, 2, 10000
13, 2, 0, 2,17, 2, 10000
9, 2, 0, 4,15, 2, 10000
9, 2, 0, 2,13, 2, 10000
8, 2, 0, 3,13, 2, 10000
7, 2, 0, 1,10, 2, 10000
10, 2, 0, 3,15, 2, 10000
11, 2, 0, 5,18, 2, 10000
10, 2, 0, 2,14, 2, 10000
7, 2, 0, 1,10, 2, 10000
7, 2, 0, 6,15, 2, 10000
8, 2, 0, 5,15, 2, 10000
4, 2, 0, 2,8, 2, 10000
12, 2, 0, 3,17, 2, 10000
13, 2, 0, 2,17, 2, 10000
6, 2, 0, 5,13, 2, 10000
9, 2, 0, 2,13, 2, 10000
2, 1, 0, 2,5, 2, 10000
10, 2, 0, 3,15, 2, 10000
8, 2, 0, 1,11, 2, 10000
9, 2, 0, 3,14, 2, 10000
8, 2, 0, 10,20, 2, 10000
11, 2, 0, 3,16, 2, 10000
5, 2, 0, 1,8, 2, 10000
5, 2, 0, 7,14, 2, 10000
10, 2, 0, 4,16, 2, 10000
7, 2, 0, 4,13, 2, 10000
4, 2, 0, 3,9, 2, 10000
9, 2, 0, 3,14, 2, 10000
8, 2, 0, 2,12, 2, 10000
16, 2, 0, 6,24, 2, 10000
7, 2, 0, 9,18, 2, 10000
9, 2, 0, 5,16, 2, 10000
4, 2, 0, 0,6, 2, 10000
12, 2, 0, 3,17, 2, 10000
10, 2, 0, 3,15, 2, 10000
10, 2, 0, 2,14, 2, 10000
5, 2, 0, 3,10, 2, 10000
4, 2, 0, 3,9, 2, 10000
7, 2, 0, 2,11, 2, 10000
6, 2, 0, 2,10, 2, 10000
6, 2, 0, 1,9, 2, 10000
7, 2, 0, 2,11, 2, 10000
11, 2, 0, 2,15, 2, 10000
12, 2, 0, 6,20, 2, 10000
10, 2, 0, 4,16, 2, 10000
12, 2, 0, 2,16, 2, 10000
12, 2, 0, 3,17, 2, 10000
8, 2, 0, 1,11, 2, 10000
9, 2, 0, 3,14, 2, 10000
8, 2, 0, 2,12, 2, 10000
13, 2, 0, 5,20, 2, 10000
9, 2, 0, 8,19, 2, 10000
7, 2, 0, 3,12, 2, 10000
11, 2, 0, 3,16, 2, 10000
11, 2, 0, 2,15, 2, 10000
8, 2, 0, 3,13, 2, 10000
14, 2, 0, 2,18, 2, 10000
9, 2, 0, 2,13, 2, 10000
9, 2, 0, 4,15, 2, 10000
7, 2, 0, 6,15, 2, 10000
11, 2, 0, 3,16, 2, 10000
7, 2, 0, 4,13, 2, 10000
3, 2, 0, 3,8, 2, 10000
14, 2, 0, 2,18, 2, 10000
15, 2, 0, 0,17, 2, 10000
3, 2, 0, 4,9, 2, 10000
6, 2, 0, 0,8, 2, 10000
6, 2, 0, 3,11, 2, 10000
5, 2, 0, 1,8, 2, 10000
13, 2, 0, 2,17, 2, 10000
17, 2, 0, 1,20, 2, 10000
7, 2, 0, 4,13, 2, 10000
8, 2, 0, 3,13, 2, 10000
6, 2, 0, 5,13, 2, 10000
9, 2, 0, 5,16, 2, 10000
13, 2, 0, 2,17, 2, 10000
7, 2, 0, 3,12, 2, 10000
9, 2, 0, 2,13, 2, 10000
7, 2, 0, 4,13, 2, 10000
7, 2, 0, 3,12, 2, 10000
10, 2, 0, 2,14, 2, 10000
14, 2, 0, 2,18, 2, 10000
9, 2, 0, 3,14, 2, 10000
5, 2, 0, 0,7, 2, 10000
11, 2, 0, 2,15, 2, 10000
11, 2, 0, 0,13, 2, 10000
10, 2, 0, 2,14, 2, 10000
15, 2, 0, 6,23, 2, 10000
12, 2, 0, 5,19, 2, 10000
6, 2, 0, 4,12, 2, 10000
2, 2, 0, 4,8, 2, 10000
10, 2, 0, 5,17, 2, 10000
6, 2, 0, 2,10, 2, 10000
5, 2, 0, 5,12, 2, 10000
11, 2, 0, 5,18, 2, 10000
4, 2, 0, 0,6, 2, 10000
2, 2, 0, 2,6, 2, 10000
6, 2, 0, 4,12, 2, 10000
7, 2, 0, 3,12, 2, 10000
8, 2, 0, 4,14, 2, 10000
9, 2, 0, 5,16, 2, 10000
10, 2, 0, 4,16, 2, 10000
10, 2, 0, 9,21, 2, 10000
11, 2, 0, 4,17, 2, 10000
4, 2, 0, 3,9, 2, 10000
4, 2, 0, 1,7, 2, 10000
8, 2, 0, 1,11, 2, 10000
14, 2, 0, 2,18, 2, 10000
7, 2, 0, 3,12, 2, 10000
14, 2, 0, 0,16, 2, 10000
7, 2, 0, 5,14, 2, 10000
15, 2, 0, 1,18, 2, 10000
4, 2, 0, 2,8, 2, 10000
10, 2, 0, 1,13, 2, 10000
7, 2, 0, 1,10, 2, 10000
9, 2, 0, 0,11, 2, 10000
12, 2, 0, 5,19, 2, 10000
3, 2, 0, 5,10, 2, 10000
11, 2, 0, 2,15, 2, 10000
2, 2, 0, 2,6, 2, 10000
13, 2, 0, 2,17, 2, 10000
5, 2, 0, 2,9, 2, 10000
9, 2, 0, 3,14, 2, 10000
3, 2, 0, 2,7, 2, 10000
7, 2, 0, 3,12, 2, 10000
17, 2, 0, 5,24, 2, 10000
12, 2, 0, 5,19, 2, 10000
10, 2, 0, 1,13, 2, 10000
8, 2, 0, 5,15, 2, 10000
11, 2, 0, 6,19, 2, 10000
6, 2, 0, 2,10, 2, 10000
6, 2, 0, 3,11, 2, 10000
9, 2, 0, 4,15, 2, 10000
8, 2, 0, 3,13, 2, 10000
5, 2, 0, 1,8, 2, 10000
6, 2, 0, 3,11, 2, 10000
11, 2, 0, 4,17, 2, 10000
6, 2, 0, 1,9, 2, 10000
11, 2, 0, 5,18, 2, 10000
11, 2, 0, 1,14, 2, 10000
13, 2, 0, 1,16, 2, 10000
12, 2, 0, 1,15, 2, 10000
11, 2, 0, 5,18, 2, 10000
8, 2, 0, 2,12, 2, 10000
13, 2, 0, 3,18, 2, 10000
7, 2, 0, 6,15, 2, 10000
5, 2, 0, 1,8, 2, 10000
11, 2, 0, 2,15, 2, 10000
9, 2, 0, 4,15, 2, 10000
7, 2, 0, 4,13, 2, 10000
7, 2, 0, 4,13, 2, 10000
13, 2, 0, 3,18, 2, 10000
12, 2, 0, 3,17, 2, 10000
9, 2, 0, 3,14, 2, 10000
2, 2, 0, 1,5, 2, 10000
8, 2, 0, 2,12, 2, 10000
9, 2, 0, 2,13, 2, 10000
10, 2, 0, 1,13, 2, 10000
6, 2, 0, 5,13, 2, 10000
10, 2, 0, 6,18, 2, 10000
8, 2, 0, 4,14, 2, 10000
7, 2, 0, 5,14, 2, 10000
10, 2, 0, 3,15, 2, 10000
5, 2, 0, 1,8, 2, 10000
9, 2, 0, 1,12, 2, 10000
10, 2, 0, 5,17, 2, 10000
17, 2, 0, 2,21, 2, 10000
9, 2, 0, 1,12, 2, 10000
7, 2, 0, 3,12, 2, 10000
14, 2, 0, 2,18, 2, 10000
9, 2, 0, 5,16, 2, 10000
10, 2, 0, 8,20, 2, 10000
9, 2, 0, 7,18, 2, 10000
8, 2, 0, 2,12, 2, 10000
8, 2, 0, 4,14, 2, 10000
11, 2, 0, 3,16, 2, 10000
8, 2, 0, 0,10, 2, 10000
8, 2, 0, 1,11, 2, 10000
5, 2, 0, 1,8, 2, 10000
11, 2, 0, 5,18, 2, 10000
13, 2, 0, 4,19, 2, 10000
4, 2, 0, 2,8, 2, 10000
6, 2, 0, 4,12, 2, 10000
8, 2, 0, 2,12, 2, 10000
11, 2, 0, 2,15, 2, 10000
3, 2, 0, 5,10, 2, 10000
13, 2, 0, 2,17, 2, 10000
7, 2, 0, 1,10, 2, 10000
6, 2, 0, 4,12, 2, 10000
11, 2, 0, 2,15, 2, 10000
15, 2, 0, 0,17, 2, 10000
6, 2, 0, 1,9, 2, 10000
14, 2, 0, 5,21, 2, 10000
6, 2, 0, 1,9, 2, 10000
10, 2, 0, 3,15, 2, 10000
6, 2, 0, 1,9, 2, 10000
11, 2, 0, 2,15, 2, 10000
7, 2, 0, 3,12, 2, 10000
14, 2, 0, 4,20, 2, 10000
11, 2, 0, 2,15, 2, 10000
11, 2, 0, 2,15, 2, 10000
4, 2, 0, 3,9, 2, 10000
9, 2, 0, 2,13, 2, 10000
9, 2, 0, 2,13, 2, 10000
16, 2, 0, 0,18, 2, 10000
8, 2, 0, 3,13, 2, 10000
12, 2, 0, 1,15, 2, 10000
11, 2, 0, 2,15, 2, 10000
5, 2, 0, 5,12, 2, 10000
13, 2, 0, 3,18, 2, 10000
16, 2, 0, 4,22, 2, 10000
6, 2, 0, 2,10, 2, 10000
7, 2, 0, 3,12, 2, 10000
13, 2, 0, 2,17, 2, 10000
16, 2, 0, 0,18, 2, 10000
12, 2, 0, 4,18, 2, 10000
2, 2, 0, 6,10, 2, 10000
14, 2, 0, 8,24, 2, 10000
7, 2, 0, 4,13, 2, 10000
8, 2, 0, 1,11, 2, 10000
7, 2, 0, 2,11, 2, 10000
9, 2, 0, 3,14, 2, 10000
8, 2, 0, 6,16, 2, 10000
10, 2, 0, 4,16, 2, 10000
8, 2, 0, 2,12, 2, 10000
12, 2, 0, 2,16, 2, 10000
3, 2, 0, 5,10, 2, 10000
11, 2, 0, 6,19, 2, 10000
7, 2, 0, 2,11, 2, 10000
14, 2, 0, 3,19, 2, 10000
8, 2, 0, 4,14, 2, 10000
14, 2, 0, 3,19, 2, 10000
19, 2, 0, 3,24, 2, 10000
8, 2, 0, 2,12, 2, 10000
12, 2, 0, 3,17, 2, 10000
8, 2, 0, 3,13, 2, 10000
7, 2, 0, 4,13, 2, 10000
10, 2, 0, 2,14, 2, 10000
7, 2, 0, 2,11, 2, 10000
5, 2, 0, 3,10, 2, 10000
7, 2, 0, 3,12, 2, 10000
12, 2, 0, 1,15, 2, 10000
12, 2, 0, 4,18, 2, 10000
12, 2, 0, 4,18, 2, 10000
13, 2, 0, 0,15, 2, 10000
10, 2, 0, 7,19, 2, 10000
10, 2, 0, 3,15, 2, 10000
9, 2, 0, 2,13, 2, 10000
4, 2, 0, 5,11, 2, 10000
10, 2, 0, 3,15, 2, 10000
13, 2, 0, 4,19, 2, 10000
6, 2, 0, 1,9, 2, 10000
13, 2, 0, 2,17, 2, 10000
8, 2, 0, 5,15, 2, 10000
15, 2, 0, 2,19, 2, 10000
3, 2, 0, 1,6, 2, 10000
7, 2, 0, 4,13, 2, 10000
4, 2, 0, 3,9, 2, 10000
14, 2, 0, 2,18, 2, 10000
7, 2, 0, 0,9, 2, 10000
10, 2, 0, 3,15, 2, 10000
7, 2, 0, 2,11, 2, 10000
3, 2, 0, 3,8, 2, 10000
6, 2, 0, 4,12, 2, 10000
8, 2, 0, 5,15, 2, 10000
5, 2, 0, 5,12, 2, 10000
13, 2, 0, 4,19, 2, 10000
3, 2, 0, 5,10, 2, 10000
6, 2, 0, 0,8, 2, 10000
8, 2, 0, 0,10, 2, 10000
13, 2, 0, 3,18, 2, 10000
7, 2, 0, 4,13, 2, 10000
13, 2, 0, 2,17, 2, 10000
7, 2, 0, 2,11, 2, 10000
8, 2, 0, 4,14, 2, 10000
6, 2, 0, 3,11, 2, 10000
7, 2, 0, 5,14, 2, 10000
7, 2, 0, 0,9, 2, 10000
12, 2, 0, 1,15, 2, 10000
7, 2, 0, 1,10, 2, 10000
11, 2, 0, 4,17, 2, 10000
7, 2, 0, 1,10, 2, 10000
12, 2, 0, 1,15, 2, 10000
9, 2, 0, 5,16, 2, 10000
9, 2, 0, 2,13, 2, 10000
19, 2, 0, 3,24, 2, 10000
5, 2, 0, 5,12, 2, 10000
5, 2, 0, 5,12, 2, 10000
5, 2, 0, 4,11, 2, 10000
11, 2, 0, 4,17, 2, 10000
10, 2, 0, 2,14, 2, 10000
8, 2, 0, 3,13, 2, 10000
8, 2, 0, 2,12, 2, 10000
5, 2, 0, 2,9, 2, 10000
10, 2, 0, 4,16, 2, 10000
5, 2, 0, 3,10, 2, 10000
12, 2, 0, 6,20, 2, 10000
3, 2, 0, 1,6, 2, 10000
8, 2, 0, 0,10, 2, 10000
14, 2, 0, 1,17, 2, 10000
6, 2, 0, 3,11, 2, 10000
12, 2, 0, 4,18, 2, 10000
11, 2, 0, 0,13, 2, 10000
11, 2, 0, 3,16, 2, 10000
10, 2, 0, 4,16, 2, 10000
12, 2, 0, 2,16, 2, 10000
14, 2, 0, 6,22, 2, 10000
10, 2, 0, 3,15, 2, 10000
7, 2, 0, 3,12, 2, 10000
17, 2, 0, 5,24, 2, 10000
18, 2, 0, 4,24, 2, 10000
13, 2, 0, 7,22, 2, 10000
10, 2, 0, 4,16, 2, 10000
18, 2, 0, 5,25, 2, 10000
12, 2, 0, 2,16, 2, 10000
9, 2, 0, 2,13, 2, 10000
5, 2, 0, 4,11, 2, 10000
6, 2, 0, 2,10, 2, 10000
10, 2, 0, 1,13, 2, 10000
9, 2, 0, 2,13, 2, 10000
12, 2, 0, 5,19, 2, 10000
11, 2, 0, 0,13, 2, 10000
9, 2, 0, 2,13, 2, 10000
8, 2, 0, 2,12, 2, 10000
6, 2, 0, 3,11, 2, 10000
9, 2, 0, 2,13, 2, 10000
14, 2, 0, 3,19, 2, 10000
7, 2, 0, 2,11, 2, 10000
13, 2, 0, 3,18, 2, 10000
12, 2, 0, 2,16, 2, 10000
9, 2, 0, 2,13, 2, 10000
11, 2, 0, 2,15, 2, 10000
6, 2, 0, 4,12, 2, 10000
11, 2, 0, 3,16, 2, 10000
5, 2, 0, 5,12, 2, 10000
10, 2, 0, 3,15, 2, 10000
8, 2, 0, 2,12, 2, 10000
12, 2, 0, 2,16, 2, 10000
8, 2, 0, 5,15, 2, 10000
14, 2, 0, 3,19, 2, 10000
7, 2, 0, 5,14, 2, 10000
6, 2, 0, 4,12, 2, 10000
12, 2, 0, 7,21, 2, 10000
9, 2, 0, 2,13, 2, 10000
11, 2, 0, 1,14, 2, 10000
3, 2, 0, 2,7, 2, 10000
8, 2, 0, 2,12, 2, 10000
8, 2, 0, 3,13, 2, 10000
14, 2, 0, 1,17, 2, 10000
6, 2, 0, 2,10, 2, 10000
2, 2, 0, 4,8, 2, 10000
5, 2, 0, 4,11, 2, 10000
6, 2, 0, 7,15, 2, 10000
8, 2, 0, 1,11, 2, 10000
10, 2, 0, 1,13, 2, 10000
12, 2, 0, 0,14, 2, 10000
10, 2, 0, 1,13, 2, 10000
13, 2, 0, 2,17, 2, 10000
8, 2, 0, 6,16, 2, 10000
6, 2, 0, 5,13, 2, 10000
9, 2, 0, 4,15, 2, 10000
6, 2, 0, 4,12, 2, 10000
11, 2, 0, 2,15, 2, 10000
7, 2, 0, 0,9, 2, 10000
5, 2, 0, 1,8, 2, 10000
14, 2, 0, 7,23, 2, 10000
16, 2, 0, 1,19, 2, 10000
6, 2, 0, 3,11, 2, 10000
5, 2, 0, 2,9, 2, 10000
10, 2, 0, 4,16, 2, 10000
10, 2, 0, 3,15, 2, 10000
9, 2, 0, 2,13, 2, 10000
3, 2, 0, 0,5, 2, 10000
7, 2, 0, 0,9, 2, 10000
9, 2, 0, 3,14, 2, 10000
5, 2, 0, 3,10, 2, 10000
6, 2, 0, 5,13, 2, 10000
11, 2, 0, 0,13, 2, 10000
11, 2, 0, 5,18, 2, 10000
6, 2, 0, 3,11, 2, 10000
11, 2, 0, 3,16, 2, 10000
10, 2, 0, 4,16, 2, 10000
9, 2, 0, 3,14, 2, 10000
8, 2, 0, 3,13, 2, 10000
9, 2, 0, 4,15, 2, 10000
13, 2, 0, 2,17, 2, 10000
9, 2, 0, 4,15, 2, 10000
6, 2, 0, 5,13, 2, 10000
10, 2, 0, 4,16, 2, 10000
13, 2, 0, 5,20, 2, 10000
5, 2, 0, 2,9, 2, 10000
4, 2, 0, 2,8, 2, 10000
9, 2, 0, 3,14, 2, 10000
8, 2, 0, 5,15, 2, 10000
9, 2, 0, 3,14, 2, 10000
14, 2, 0, 1,17, 2, 10000
8, 2, 0, 4,14, 2, 10000
15, 2, 0, 4,21, 2, 10000
10, 2, 0, 1,13, 2, 10000
9, 2, 0, 3,14, 2, 10000
16, 2, 0, 2,20, 2, 10000
6, 2, 0, 4,12, 2, 10000
16, 2, 0, 1,19, 2, 10000
10, 2, 0, 2,14, 2, 10000
13, 2, 0, 4,19, 2, 10000
8, 2, 0, 3,13, 2, 10000
11, 2, 0, 4,17, 2, 10000
7, 2, 0, 2,11, 2, 10000
6, 2, 0, 2,10, 2, 10000
8, 2, 0, 2,12, 2, 10000
16, 2, 0, 5,23, 2, 10000
12, 2, 0, 1,15, 2, 10000
8, 2, 0, 2,12, 2, 10000
2, 2, 0, 4,8, 2, 10000
5, 2, 0, 3,10, 2, 10000
4, 2, 0, 1,7, 2, 10000
7, 2, 0, 3,12, 2, 10000
11, 2, 0, 5,18, 2, 10000
12, 2, 0, 4,18, 2, 10000
11, 2, 0, 1,14, 2, 10000
7, 2, 0, 4,13, 2, 10000
7, 2, 0, 5,14, 2, 10000
10, 2, 0, 2,14, 2, 10000
10, 2, 0, 2,14, 2, 10000
15, 2, 0, 1,18, 2, 10000
6, 2, 0, 2,10, 2, 10000
7, 2, 0, 3,12, 2, 10000
10, 2, 0, 7,19, 2, 10000
6, 2, 0, 2,10, 2, 10000
7, 2, 0, 2,11, 2, 10000
5, 2, 0, 2,9, 2, 10000
6, 2, 0, 1,9, 2, 10000
14, 2, 0, 3,19, 2, 10000
4, 2, 0, 2,8, 2, 10000
14, 2, 0, 2,18, 2, 10000
11, 2, 0, 5,18, 2, 10000
5, 2, 0, 2,9, 2, 10000
8, 2, 0, 1,11, 2, 10000
10, 2, 0, 3,15, 2, 10000
7, 2, 0, 7,16, 2, 10000
10, 2, 0, 4,16, 2, 10000
8, 2, 0, 5,15, 2, 10000
9, 2, 0, 3,14, 2, 10000
5, 2, 0, 2,9, 2, 10000
13, 2, 0, 5,20, 2, 10000
11, 2, 0, 4,17, 2, 10000
5, 2, 0, 5,12, 2, 10000
4, 2, 0, 3,9, 2, 10000
11, 2, 0, 6,19, 2, 10000
4, 2, 0, 3,9, 2, 10000
12, 2, 0, 1,15, 2, 10000
12, 2, 0, 6,20, 2, 10000
7, 2, 0, 1,10, 2, 10000
12, 2, 0, 4,18, 2, 10000
5, 2, 0, 3,10, 2, 10000
15, 2, 0, 3,20, 2, 10000
5, 2, 0, 3,10, 2, 10000
5, 2, 0, 4,11, 2, 10000
6, 2, 0, 4,12, 2, 10000
2, 2, 0, 3,7, 2, 10000
12, 2, 0, 1,15, 2, 10000
9, 2, 0, 3,14, 2, 10000
5, 2, 0, 3,10, 2, 10000
5, 2, 0, 6,13, 2, 10000
10, 2, 0, 2,14, 2, 10000
4, 2, 0, 0,6, 2, 10000
11, 2, 0, 2,15, 2, 10000
6, 2, 0, 1,9, 2, 10000
7, 2, 0, 1,10, 2, 10000
2, 1, 0, 6,9, 2, 10000
2, 2, 0, 2,6, 2, 10000
8, 2, 0, 1,11, 2, 10000
14, 2, 0, 1,17, 2, 10000
13, 2, 0, 3,18, 2, 10000
2, 0, 0, 4,6, 2, 10000
7, 2, 0, 2,11, 2, 10000
6, 2, 0, 4,12, 2, 10000
5, 2, 0, 1,8, 2, 10000
4, 2, 0, 0,6, 2, 10000
11, 2, 0, 3,16, 2, 10000
7, 2, 0, 5,14, 2, 10000
10, 2, 0, 0,12, 2, 10000
5, 2, 0, 3,10, 2, 10000
11, 2, 0, 3,16, 2, 10000
2, 2, 0, 7,11, 2, 10000
13, 2, 0, 3,18, 2, 10000
6, 2, 0, 8,16, 2, 10000
10, 2, 0, 4,16, 2, 10000
6, 2, 0, 3,11, 2, 10000
11, 2, 0, 2,15, 2, 10000
13, 2, 0, 2,17, 2, 10000
13, 2, 0, 1,16, 2, 10000
7, 2, 0, 1,10, 2, 10000
6, 2, 0, 2,10, 2, 10000
9, 2, 0, 2,13, 2, 10000
4, 2, 0, 1,7, 2, 10000
6, 2, 0, 1,9, 2, 10000
5, 2, 0, 0,7, 2, 10000
5, 2, 0, 3,10, 2, 10000
9, 2, 0, 2,13, 2, 10000
9, 2, 0, 7,18, 2, 10000
7, 2, 0, 4,13, 2, 10000
6, 2, 0, 4,12, 2, 10000
7, 2, 0, 3,12, 2, 10000
8, 2, 0, 2,12, 2, 10000
11, 2, 0, 2,15, 2, 10000
5, 2, 0, 5,12, 2, 10000
8, 2, 0, 3,13, 2, 10000
7, 2, 0, 2,11, 2, 10000
14, 2, 0, 3,19, 2, 10000
7, 2, 0, 3,12, 2, 10000
8, 2, 0, 3,13, 2, 10000
10, 2, 0, 3,15, 2, 10000
13, 2, 0, 2,17, 2, 10000
7, 2, 0, 0,9, 2, 10000
6, 2, 0, 1,9, 2, 10000
11, 2, 0, 5,18, 2, 10000
20, 2, 0, 2,24, 2, 10000
6, 2, 0, 3,11, 2, 10000
7, 2, 0, 1,10, 2, 10000
8, 2, 0, 3,13, 2, 10000
9, 2, 0, 3,14, 2, 10000
9, 2, 0, 2,13, 2, 10000
8, 2, 0, 4,14, 2, 10000
7, 2, 0, 4,13, 2, 10000
1, 1, 0, 5,7, 2, 10000
11, 2, 0, 6,19, 2, 10000
10, 2, 0, 1,13, 2, 10000
9, 2, 0, 8,19, 2, 10000
7, 2, 0, 1,10, 2, 10000
3, 2, 0, 2,7, 2, 10000
9, 2, 0, 7,18, 2, 10000
8, 2, 0, 2,12, 2, 10000
10, 2, 0, 5,17, 2, 10000
9, 2, 0, 2,13, 2, 10000
13, 2, 0, 1,16, 2, 10000
8, 2, 0, 2,12, 2, 10000
7, 2, 0, 2,11, 2, 10000
11, 2, 0, 1,14, 2, 10000
6, 2, 0, 3,11, 2, 10000
13, 2, 0, 2,17, 2, 10000
5, 2, 0, 2,9, 2, 10000
5, 2, 0, 4,11, 2, 10000
13, 2, 0, 5,20, 2, 10000
3, 2, 0, 5,10, 2, 10000
8, 2, 0, 3,13, 2, 10000
6, 2, 0, 2,10, 2, 10000
11, 2, 0, 6,19, 2, 10000
9, 2, 0, 2,13, 2, 10000
8, 2, 0, 4,14, 2, 10000
4, 2, 0, 1,7, 2, 10000
1, 2, 0, 3,6, 2, 10000
7, 2, 0, 2,11, 2, 10000
6, 2, 0, 1,9, 2, 10000
10, 2, 0, 2,14, 2, 10000
6, 2, 0, 1,9, 2, 10000
9, 2, 0, 1,12, 2, 10000
7, 2, 0, 0,9, 2, 10000
8, 2, 0, 2,12, 2, 10000
3, 2, 0, 1,6, 2, 10000
7, 2, 0, 4,13, 2, 10000
9, 2, 0, 1,12, 2, 10000
3, 2, 0, 4,9, 2, 10000
13, 2, 0, 7,22, 2, 10000
4, 2, 0, 3,9, 2, 10000
6, 2, 0, 3,11, 2, 10000
4, 2, 0, 5,11, 2, 10000
9, 2, 0, 1,12, 2, 10000
7, 2, 0, 4,13, 2, 10000
3, 2, 0, 3,8, 2, 10000
2, 2, 0, 5,9, 2, 10000
4, 2, 0, 2,8, 2, 10000
10, 2, 0, 3,15, 2, 10000
2, 2, 0, 1,5, 2, 10000
8, 2, 0, 1,11, 2, 10000
10, 2, 0, 3,15, 2, 10000
8, 2, 0, 4,14, 2, 10000
4, 2, 0, 4,10, 2, 10000
4, 2, 0, 2,8, 2, 10000
11, 2, 0, 1,14, 2, 10000
7, 2, 0, 1,10, 2, 10000
11, 2, 0, 3,16, 2, 10000
12, 2, 0, 1,15, 2, 10000
13, 2, 0, 3,18, 2, 10000
10, 2, 0, 2,14, 2, 10000
10, 2, 0, 2,14, 2, 10000
5, 2, 0, 2,9, 2, 10000
9, 2, 0, 5,16, 2, 10000
5, 2, 0, 1,8, 2, 10000
15, 2, 0, 2,19, 2, 10000
10, 2, 0, 2,14, 2, 10000
13, 2, 0, 2,17, 2, 10000
4, 2, 0, 6,12, 2, 10000
9, 2, 0, 2,13, 2, 10000
8, 2, 0, 2,12, 2, 10000
11, 2, 0, 0,13, 2, 10000
8, 2, 0, 5,15, 2, 10000
10, 2, 0, 1,13, 2, 10000
5, 2, 0, 4,11, 2, 10000
4, 2, 0, 1,7, 2, 10000
10, 2, 0, 4,16, 2, 10000
10, 2, 0, 4,16, 2, 10000
9, 2, 0, 2,13, 2, 10000
8, 2, 0, 4,14, 2, 10000
9, 2, 0, 2,13, 2, 10000
1, 2, 0, 5,8, 2, 10000
12, 2, 0, 1,15, 2, 10000
7, 2, 0, 1,10, 2, 10000
10, 2, 0, 3,15, 2, 10000
8, 2, 0, 0,10, 2, 10000
12, 2, 0, 3,17, 2, 10000
3, 2, 0, 4,9, 2, 10000
9, 2, 0, 4,15, 2, 10000
8, 2, 0, 1,11, 2, 10000
3, 2, 0, 2,7, 2, 10000
12, 2, 0, 6,20, 2, 10000
12, 2, 0, 5,19, 2, 10000
2, 2, 0, 5,9, 2, 10000
3, 2, 0, 4,9, 2, 10000
2, 2, 0, 2,6, 2, 10000
7, 2, 0, 2,11, 2, 10000
6, 2, 0, 1,9, 2, 10000
12, 2, 0, 3,17, 2, 10000
8, 2, 0, 4,14, 2, 10000
13, 2, 0, 1,16, 2, 10000
10, 2, 0, 4,16, 2, 10000
5, 2, 0, 1,8, 2, 10000
12, 2, 0, 4,18, 2, 10000
7, 2, 0, 7,16, 2, 10000
5, 2, 0, 1,8, 2, 10000
6, 2, 0, 4,12, 2, 10000
8, 2, 0, 1,11, 2, 10000
10, 2, 0, 1,13, 2, 10000
10, 2, 0, 4,16, 2, 10000
8, 2, 0, 2,12, 2, 10000
10, 2, 0, 4,16, 2, 10000
7, 2, 0, 3,12, 2, 10000
8, 2, 0, 1,11, 2, 10000
5, 2, 0, 4,11, 2, 10000
4, 2, 0, 4,10, 2, 10000
10, 2, 0, 2,14, 2, 10000
9, 2, 0, 3,14, 2, 10000
7, 2, 0, 6,15, 2, 10000
7, 2, 0, 4,13, 2, 10000
8, 2, 0, 4,14, 2, 10000
8, 2, 0, 2,12, 2, 10000
13, 2, 0, 3,18, 2, 10000
9, 2, 0, 5,16, 2, 10000
8, 2, 0, 3,13, 2, 10000
6, 2, 0, 3,11, 2, 10000
4, 2, 0, 2,8, 2, 10000
13, 2, 0, 6,21, 2, 10000
11, 2, 0, 3,16, 2, 10000
14, 2, 0, 6,22, 2, 10000
9, 2, 0, 2,13, 2, 10000
8, 2, 0, 3,13, 2, 10000
11, 2, 0, 3,16, 2, 10000
8, 2, 0, 3,13, 2, 10000
11, 2, 0, 2,15, 2, 10000
10, 2, 0, 2,14, 2, 10000
6, 2, 0, 2,10, 2, 10000
8, 2, 0, 2,12, 2, 10000
7, 2, 0, 1,10, 2, 10000
10, 2, 0, 3,15, 2, 10000
16, 2, 0, 1,19, 2, 10000
7, 2, 0, 3,12, 2, 10000
5, 2, 0, 2,9, 2, 10000
4, 2, 0, 4,10, 2, 10000
6, 2, 0, 1,9, 2, 10000
10, 2, 0, 5,17, 2, 10000
6, 2, 0, 4,12, 2, 10000
9, 2, 0, 2,13, 2, 10000
13, 2, 0, 2,17, 2, 10000
8, 2, 0, 0,10, 2, 10000
8, 2, 0, 0,10, 2, 10000
1, 2, 0, 3,6, 2, 10000
10, 2, 0, 2,14, 2, 10000
7, 2, 0, 4,13, 2, 10000
3, 2, 0, 3,8, 2, 10000
11, 2, 0, 2,15, 2, 10000
5, 2, 0, 6,13, 2, 10000
4, 2, 0, 4,10, 2, 10000
8, 2, 0, 1,11, 2, 10000
6, 2, 0, 2,10, 2, 10000
5, 2, 0, 5,12, 2, 10000
4, 2, 0, 4,10, 2, 10000
8, 2, 0, 1,11, 2, 10000
8, 2, 0, 3,13, 2, 10000
12, 2, 0, 4,18, 2, 10000
8, 2, 0, 3,13, 2, 10000
4, 2, 0, 3,9, 2, 10000
4, 2, 0, 5,11, 2, 10000
11, 2, 0, 0,13, 2, 10000
9, 2, 0, 2,13, 2, 10000
8, 2, 0, 0,10, 2, 10000
4, 2, 0, 0,6, 2, 10000
8, 2, 0, 3,13, 2, 10000
4, 2, 0, 2,8, 2, 10000
10, 2, 0, 3,15, 2, 10000
8, 2, 0, 1,11, 2, 10000
7, 2, 0, 3,12, 2, 10000
12, 2, 0, 0,14, 2, 10000
4, 2, 0, 4,10, 2, 10000
10, 2, 0, 0,12, 2, 10000
5, 2, 0, 1,8, 2, 10000
10, 2, 0, 2,14, 2, 10000
7, 2, 0, 0,9, 2, 10000
6, 2, 0, 1,9, 2, 10000
11, 2, 0, 2,15, 2, 10000
11, 2, 0, 1,14, 2, 10000
13, 2, 0, 4,19, 2, 10000
9, 2, 0, 3,14, 2, 10000
13, 2, 0, 3,18, 2, 10000
6, 2, 0, 4,12, 2, 10000
3, 2, 0, 2,7, 2, 10000
7, 2, 0, 1,10, 2, 10000
5, 2, 0, 1,8, 2, 10000
8, 2, 0, 2,12, 2, 10000
9, 2, 0, 3,14, 2, 10000
17, 2, 0, 5,24, 2, 10000
12, 2, 0, 4,18, 2, 10000
10, 2, 0, 4,16, 2, 10000
9, 2, 0, 4,15, 2, 10000
11, 2, 0, 2,15, 2, 10000
2, 1, 0, 8,11, 2, 10000
12, 2, 0, 1,15, 2, 10000
5, 2, 0, 3,10, 2, 10000
4, 2, 0, 3,9, 2, 10000
8, 2, 0, 6,16, 2, 10000
9, 2, 0, 3,14, 2, 10000
6, 2, 0, 6,14, 2, 10000
9, 2, 0, 3,14, 2, 10000
9, 2, 0, 4,15, 2, 10000
13, 2, 0, 0,15, 2, 10000
9, 2, 0, 3,14, 2, 10000
11, 2, 0, 5,18, 2, 10000
7, 2, 0, 4,13, 2, 10000
12, 2, 0, 6,20, 2, 10000
11, 2, 0, 4,17, 2, 10000
13, 2, 0, 4,19, 2, 10000
8, 2, 0, 3,13, 2, 10000
7, 2, 0, 2,11, 2, 10000
4, 2, 0, 3,9, 2, 10000
7, 2, 0, 7,16, 2, 10000
4, 2, 0, 4,10, 2, 10000
5, 2, 0, 1,8, 2, 10000
10, 2, 0, 4,16, 2, 10000
8, 2, 0, 4,14, 2, 10000
5, 2, 0, 0,7, 2, 10000
12, 2, 0, 4,18, 2, 10000
13, 2, 0, 6,21, 2, 10000
10, 2, 0, 3,15, 2, 10000
5, 2, 0, 1,8, 2, 10000
7, 2, 0, 1,10, 2, 10000
5, 2, 0, 1,8, 2, 10000
5, 2, 0, 1,8, 2, 10000
12, 2, 0, 1,15, 2, 10000
3, 2, 0, 4,9, 2, 10000
12, 2, 0, 2,16, 2, 10000
12, 2, 0, 2,16, 2, 10000
10, 2, 0, 3,15, 2, 10000
16, 2, 0, 2,20, 2, 10000
4, 2, 0, 4,10, 2, 10000
10, 2, 0, 1,13, 2, 10000
4, 2, 0, 3,9, 2, 10000
8, 2, 0, 0,10, 2, 10000
8, 2, 0, 6,16, 2, 10000
8, 2, 0, 2,12, 2, 10000
9, 2, 0, 2,13, 2, 10000
17, 2, 0, 2,21, 2, 10000
22, 2, 0, 1,25, 2, 10000
9, 2, 0, 1,12, 2, 10000
8, 2, 0, 2,12, 2, 10000
6, 2, 0, 2,10, 2, 10000
8, 2, 0, 2,12, 2, 10000
8, 2, 0, 1,11, 2, 10000























































































































